county,Housing gap,Total ELI renters,Housing gap (asst off),Units per 100 renters,Units per 100 renters (asst off),Number of HUD asst units,AAA units,AAA units (asst off)
National,8185518,11471157,10815011,29,6,2629493,3285639,656146
1001,496,803,640,38,20,144,307,163
1003,3981,6831,4473,42,35,492,2850,2358
1005,634,913,1113,31,0,479,279,0
1007,221,586,302,62,48,81,365,284
1009,513,1083,815,53,25,302,570,268
1011,163,235,383,31,0,220,72,0
1013,462,971,677,52,30,215,508,293
1015,2337,3620,3452,35,5,1115,1283,168
1017,501,1284,803,61,37,302,783,481
1019,277,697,414,60,41,137,420,283
1021,387,992,494,61,50,107,605,498
1023,131,256,132,49,48,1,125,124
1025,479,933,555,49,41,76,454,378
1027,108,272,281,60,0,173,164,0
1029,134,337,197,60,42,63,203,140
1031,844,1772,1247,52,30,403,928,525
1033,892,1418,1610,37,0,718,525,0
1035,294,572,472,49,18,178,279,101
1037,68,173,72,61,59,4,106,102
1039,636,1335,941,52,30,305,699,394
1041,196,412,399,52,3,203,216,13
1043,1321,2967,1691,55,43,370,1646,1276
1045,811,1456,1303,44,10,492,645,153
1047,1185,3137,2300,62,27,1115,1952,837
1049,462,743,921,38,0,459,281,0
1051,674,1090,811,38,26,137,417,280
1053,956,1861,1166,49,37,210,906,696
1055,1796,2610,2808,31,0,1012,814,0
1057,245,635,436,61,31,191,389,198
1059,462,733,840,37,0,378,272,0
1061,381,683,652,44,5,271,303,32
1063,141,373,320,62,14,179,232,53
1065,190,503,304,62,40,114,313,199
1067,161,290,281,44,3,120,128,8
1069,1811,3251,2882,44,11,1071,1439,368
1071,432,694,799,38,0,367,262,0
1073,18172,30518,28780,40,6,10608,12346,1738
1075,190,490,404,61,18,214,301,87
1077,1974,3137,3034,37,3,1060,1163,103
1079,436,785,582,44,26,146,349,203
1081,4978,7524,6102,34,19,1124,2546,1422
1083,1421,2492,1957,43,21,536,1072,536
1085,104,168,276,38,0,172,64,0
1087,655,944,1135,31,0,480,289,0
1089,7144,10425,9691,31,7,2547,3281,734
1091,337,892,572,62,36,235,555,320
1093,357,821,752,56,8,395,463,68
1095,1115,2790,2099,60,25,984,1674,690
1097,10388,14570,16435,29,0,6047,4182,0
1099,423,824,567,49,31,144,401,257
1101,8524,11354,11522,25,0,2998,2830,0
1103,2486,4474,3359,44,25,873,1988,1115
1105,192,508,343,62,32,151,316,165
1107,528,1133,749,53,34,221,604,383
1109,1378,1985,1901,31,4,523,608,85
1111,270,678,373,60,45,103,409,306
1113,1969,2837,2832,31,0,863,868,5
1115,944,1995,1135,53,43,191,1051,860
1117,3420,3861,3718,11,4,298,441,143
1119,356,942,672,62,29,316,586,270
1121,1187,2986,2130,60,29,943,1799,856
1123,451,1156,913,61,21,462,705,243
1125,6757,9320,9149,28,2,2392,2564,172
1127,678,1754,1236,61,30,558,1076,518
1129,135,263,154,49,41,19,128,109
1131,208,405,290,49,28,82,197,115
1133,347,779,570,55,27,223,432,209
2013,16,23,16,31,31,,7,7
2016,56,81,56,31,31,,25,25
2020,6875,9426,8719,27,8,1844,2551,707
2050,130,188,199,31,0,69,59,0
2060,15,21,15,31,31,,7,7
2068,13,22,13,43,43,,9,9
2070,48,70,54,31,23,6,22,16
2090,2264,3939,2807,43,29,543,1675,1132
2100,53,92,53,43,43,,39,39
2110,629,1094,1126,43,0,497,465,0
2122,1033,1352,1238,24,8,205,318,113
2150,240,349,292,31,16,52,109,57
2164,15,21,15,31,31,,7,7
2170,1404,1836,1652,24,10,248,433,185
2180,129,188,141,31,25,12,58,46
2185,49,71,51,31,28,2,22,20
2188,68,99,68,31,31,,31,31
2220,344,500,371,31,26,27,156,129
2232,56,85,56,34,34,,29,29
2240,53,92,53,43,43,,39,39
2261,92,161,129,43,20,37,68,31
2270,27,39,27,31,31,,12,12
2282,15,22,15,31,31,,7,7
2290,56,81,56,31,31,,25,25
2999,521,859,648,39,25,127,337,210
4001,368,923,427,60,54,59,555,496
4003,2538,3868,3081,34,20,543,1330,787
4005,3209,4646,3650,31,21,441,1437,996
4007,862,1675,914,49,45,52,813,761
4009,363,706,394,49,44,31,342,311
4011,106,207,106,49,49,,100,100
4012,217,405,217,46,46,,188,188
4013,108549,126433,121968,14,4,13419,17884,4465
4015,3268,6099,3498,46,43,230,2831,2601
4017,1064,2669,1163,60,56,99,1605,1506
4019,34478,41439,39720,17,4,5242,6961,1719
4021,4381,7112,4897,38,31,516,2731,2215
4023,900,1372,1185,34,14,285,472,187
4025,5152,5469,5442,6,0,290,317,27
4027,4173,5918,5196,29,12,1023,1745,722
5001,526,696,810,24,0,284,170,0
5003,463,708,617,35,13,154,246,92
5005,628,1038,784,39,24,156,409,253
5007,6308,7555,6820,17,10,512,1247,735
5009,477,788,838,39,0,361,311,0
5011,287,440,412,35,6,125,153,28
5013,47,68,59,31,13,12,21,9
5015,402,664,492,39,26,90,262,172
5017,419,642,532,35,17,113,223,110
5019,743,888,1006,16,0,263,145,0
5021,259,382,365,32,4,106,122,16
5023,207,488,291,58,40,84,280,196
5025,105,160,127,35,21,22,56,34
5027,503,724,677,31,7,174,221,47
5029,130,263,326,51,0,196,133,0
5031,2532,3785,3692,33,2,1160,1253,93
5033,1041,1503,1432,31,5,391,461,70
5035,1351,2491,2229,46,10,878,1139,261
5037,380,628,597,39,5,217,248,31
5039,183,264,252,31,4,69,81,12
5041,558,854,865,35,0,307,296,0
5043,744,1139,930,35,18,186,395,209
5045,3197,4128,3647,23,12,450,931,481
5047,349,383,422,9,0,73,34,0
5049,93,218,164,58,25,71,125,54
5051,2945,3521,3539,16,0,594,575,0
5053,199,242,239,18,1,40,43,3
5055,843,1242,1143,32,8,300,398,98
5057,431,850,653,49,23,222,419,197
5059,690,825,845,16,0,155,135,0
5061,352,387,453,9,0,101,35,0
5063,475,1119,683,58,39,208,643,435
5065,124,292,211,58,28,87,168,81
5067,352,594,680,41,0,328,242,0
5069,2556,3106,3270,18,0,714,550,0
5071,192,389,315,51,19,123,196,73
5073,74,146,92,49,37,18,72,54
5075,257,378,518,32,0,261,121,0
5077,276,456,621,39,0,345,180,0
5079,276,422,335,35,21,59,146,87
5081,112,221,239,49,0,127,109,0
5083,452,496,570,9,0,118,44,0
5085,1260,1627,1833,23,0,573,367,0
5087,142,234,233,39,1,91,92,1
5089,165,273,220,39,19,55,107,52
5091,760,1499,1361,49,9,601,739,138
5093,984,1813,1716,46,5,732,829,97
5095,269,444,429,39,3,160,175,15
5097,178,212,199,16,6,21,35,14
5099,119,234,227,49,3,108,116,8
5101,72,118,82,39,31,10,47,37
5103,491,707,890,31,0,399,216,0
5105,27,55,46,51,16,19,28,9
5107,900,1487,1462,39,2,562,587,25
5109,125,247,184,49,25,59,122,63
5111,636,1050,1099,39,0,463,415,0
5113,346,380,443,9,0,97,34,0
5115,389,786,779,51,1,390,397,7
5117,149,251,188,41,25,39,102,63
5119,13131,17085,17586,23,0,4455,3954,0
5121,267,393,446,32,0,179,126,0
5123,881,1456,1488,39,0,607,575,0
5125,1066,1581,1457,33,8,391,515,124
5127,216,237,291,9,0,75,21,0
5129,97,161,111,39,31,14,63,49
5131,3298,4758,4390,31,8,1092,1461,369
5133,370,407,468,9,0,98,36,0
5135,136,321,226,58,29,90,184,94
5137,73,173,119,58,31,46,99,53
5139,781,1125,1219,31,0,438,344,0
5141,105,247,145,58,41,40,142,102
5143,6857,8794,7857,22,11,1000,1937,937
5145,1748,2951,2273,41,23,525,1203,678
5147,192,324,380,41,0,188,132,0
5149,141,284,257,51,10,116,143,27
6001,55147,76927,72379,28,6,17232,21780,4548
6003,7,14,9,52,38,2,7,5
6005,347,729,449,52,38,102,382,280
6007,7138,7910,8426,10,0,1288,772,0
6009,369,775,401,52,48,32,406,374
6011,381,560,445,32,21,64,179,115
6013,27262,35272,34284,23,3,7022,8010,988
6015,807,1160,963,30,17,156,353,197
6017,2871,3776,3343,24,11,472,905,433
6019,32233,40350,39357,20,2,7124,8117,993
6021,518,761,587,32,23,69,244,175
6023,5827,6467,6641,10,0,814,640,0
6025,5123,7734,6921,34,11,1798,2611,813
6027,271,569,277,52,51,6,298,292
6029,20554,24949,23289,18,7,2735,4395,1660
6031,3196,4026,3774,21,6,578,830,252
6033,2763,3365,3001,18,11,238,602,364
6035,797,1145,882,30,23,85,349,264
6037,441227,534021,529713,17,1,88486,92794,4308
6039,4119,5067,4511,19,11,392,948,556
6041,7576,9153,9997,17,0,2421,1577,0
6043,154,324,193,52,40,39,170,131
6045,3562,4337,4131,18,5,569,775,206
6047,8229,10780,9866,24,8,1637,2551,914
6049,204,293,286,30,2,82,89,7
6051,217,455,220,52,52,3,239,236
6053,9140,10902,11578,16,0,2438,1762,0
6055,2032,3680,2976,45,19,944,1648,704
6057,1914,2690,2058,29,24,144,776,632
6059,90424,110056,110193,18,0,19769,19632,0
6061,5680,6941,6362,18,8,682,1261,579
6063,464,667,621,30,7,157,203,46
6065,48324,59483,54316,19,9,5992,11159,5167
6067,61468,72941,73264,16,0,11796,11473,0
6069,1313,1485,1483,12,0,170,172,2
6071,54884,64234,61170,15,5,6286,9350,3064
6073,97523,116244,118929,16,0,21406,18721,0
6075,45315,69928,61918,35,11,16603,24613,8010
6077,21159,24987,24942,15,0,3783,3828,45
6079,8133,10074,9456,19,6,1323,1941,618
6081,20678,25400,24363,19,4,3685,4722,1037
6083,11326,15071,15221,25,0,3895,3745,0
6085,49353,67603,63642,27,6,14289,18250,3961
6087,7728,10909,10975,29,0,3247,3181,0
6089,4455,6031,5397,26,11,942,1576,634
6091,43,61,50,29,17,7,18,11
6093,1499,2155,1777,30,18,278,656,378
6095,11661,15179,14940,23,2,3279,3518,239
6097,14113,16827,17887,16,0,3774,2714,0
6099,17579,20631,20210,15,2,2631,3052,421
6101,2551,3121,3036,18,3,485,570,85
6103,1372,2017,1661,32,18,289,645,356
6105,272,399,282,32,29,10,128,118
6107,13856,17625,15009,21,15,1153,3769,2616
6109,751,1579,878,52,44,127,827,700
6111,20089,24988,25668,20,0,5579,4899,0
6113,8177,10591,9859,23,7,1682,2414,732
6115,1996,2441,2450,18,0,454,445,0
8001,9432,13167,11974,28,9,2542,3735,1193
8003,426,1034,576,59,44,150,608,458
8005,16996,21159,20092,20,5,3096,4163,1067
8007,64,275,131,77,52,67,211,144
8009,48,117,81,59,31,33,69,36
8011,93,180,162,48,10,69,87,18
8013,12332,15609,14749,21,6,2417,3277,860
8014,676,890,676,24,24,,214,214
8015,214,423,285,50,33,71,210,139
8017,8,16,15,48,4,7,8,1
8019,168,251,188,33,25,20,83,63
8021,129,313,214,59,32,85,184,99
8023,61,148,90,59,39,29,87,58
8025,21,41,50,48,0,29,20,0
8027,32,63,39,50,38,7,31,24
8029,353,818,547,57,33,194,464,270
8031,27064,41773,39537,35,5,12473,14709,2236
8033,4,15,4,77,77,,12,12
8035,2846,3181,2936,11,8,90,336,246
8037,1250,1540,1280,19,17,30,290,260
8039,122,157,131,22,16,9,35,26
8041,16463,20153,19655,18,2,3192,3690,498
8043,523,1036,714,50,31,191,513,322
8045,1238,1977,1540,37,22,302,739,437
8047,161,241,174,33,28,13,80,67
8049,228,281,269,19,4,41,53,12
8051,168,726,239,77,67,71,558,487
8053,2,6,2,77,77,,5,5
8055,76,150,185,50,0,109,74,0
8057,18,22,20,19,10,2,4,2
8059,14234,16791,16872,15,0,2638,2557,0
8061,14,27,18,48,33,4,13,9
8063,95,183,147,48,20,52,88,36
8065,109,216,145,50,33,36,107,71
8067,406,1752,671,77,62,265,1346,1081
8069,11275,13904,12908,19,7,1633,2629,996
8071,338,820,598,59,27,260,482,222
8073,80,155,122,48,21,42,75,33
8075,226,436,385,48,12,159,210,51
8077,3051,5263,4197,42,20,1146,2211,1065
8079,9,22,9,59,59,,13,13
8081,233,372,352,37,5,119,139,20
8083,180,778,386,77,50,206,598,392
8085,489,1133,794,57,30,305,643,338
8087,408,788,595,48,24,187,380,193
8089,596,1445,949,59,34,353,850,497
8091,39,90,44,57,51,5,51,46
8093,98,194,107,50,45,9,96,87
8095,36,69,72,48,0,36,33,0
8097,364,448,373,19,17,9,84,75
8099,280,681,467,59,31,187,400,213
8101,3807,5438,5736,30,0,1929,1631,0
8103,56,90,77,37,14,21,34,13
8105,220,533,333,59,38,113,313,200
8107,450,719,488,37,32,38,269,231
8109,152,368,204,59,45,52,216,164
8111,16,70,20,77,71,4,54,50
8113,156,360,184,57,49,28,205,177
8115,21,40,42,48,0,21,19,0
8117,638,787,656,19,17,18,148,130
8119,188,223,210,16,6,22,35,13
8121,47,90,62,48,32,15,43,28
8123,4851,7388,6542,34,11,1691,2538,847
8125,103,200,173,48,13,70,96,26
9001,24738,38437,36399,36,5,11661,13699,2038
9003,27686,45122,42401,39,6,14715,17436,2721
9005,3633,5635,4920,36,13,1287,2002,715
9007,3093,5123,4271,40,17,1178,2030,852
9009,30075,44027,45228,32,0,15153,13952,0
9011,5264,9236,7859,43,15,2595,3972,1377
9013,2295,3887,3084,41,21,789,1592,803
9015,2112,5143,3545,59,31,1433,3031,1598
10001,2321,3733,3471,38,7,1150,1412,262
10003,9907,15364,15009,36,2,5102,5457,355
10005,3128,4345,3935,28,9,807,1217,410
11001,27807,50248,45213,45,10,17406,22441,5035
12001,12047,13794,13954,13,0,1907,1747,0
12003,398,770,590,48,23,192,372,180
12005,4065,5929,5345,31,10,1280,1865,585
12007,395,647,474,39,27,79,253,174
12009,8094,11069,10730,27,3,2636,2975,339
12011,46936,54736,54783,14,0,7847,7800,0
12013,200,429,268,53,37,68,229,161
12015,1606,2208,2008,27,9,402,602,200
12017,1537,1920,1611,20,16,74,383,309
12019,3055,3771,3291,19,13,236,716,480
12021,3142,6492,3880,52,40,738,3350,2612
12023,1086,1781,1213,39,32,127,695,568
12027,406,577,469,30,19,63,171,108
12029,131,214,154,39,28,23,84,61
12031,25826,35502,35962,27,0,10136,9676,0
12033,7282,10101,10209,28,0,2927,2819,0
12035,1283,1350,1525,5,0,242,67,0
12037,269,576,313,53,46,44,307,263
12039,758,1624,1201,53,26,443,866,423
12041,212,348,247,39,29,35,136,101
12043,149,215,150,31,30,1,66,65
12045,222,475,255,53,46,33,253,220
12047,176,337,242,48,28,66,160,94
12049,330,468,391,30,17,61,138,77
12051,642,928,738,31,20,96,286,190
12053,3055,3631,3313,16,9,258,576,318
12055,1590,2260,1765,30,22,175,670,495
12057,35108,42930,42186,18,2,7078,7822,744
12059,207,302,302,31,0,95,95,0
12061,4034,4731,4254,15,10,220,697,477
12063,614,1316,980,53,26,366,702,336
12065,230,494,325,53,34,95,263,168
12067,72,137,98,48,29,26,65,39
12069,5851,8511,6390,31,25,539,2660,2121
12071,12497,13729,14751,9,0,2254,1232,0
12073,14266,16671,16234,14,3,1968,2405,437
12075,464,761,610,39,20,146,297,151
12077,46,100,54,53,45,8,53,45
12079,340,649,466,48,28,126,309,183
12081,7175,8055,8451,11,0,1276,880,0
12083,5907,7452,6883,21,8,976,1545,569
12085,4299,4387,4448,2,0,149,88,0
12086,86447,113174,115612,24,0,29165,26727,0
12087,1604,2436,2448,34,0,844,832,0
12089,1140,2205,1261,48,43,121,1065,944
12091,4166,5303,4954,21,7,788,1137,349
12093,807,1166,809,31,31,2,359,357
12095,32046,36927,36239,13,2,4193,4881,688
12097,6335,6572,6880,4,0,545,237,0
12099,30318,36762,36076,18,2,5758,6444,686
12101,7058,8184,8306,14,0,1248,1126,0
12103,21132,26198,26057,19,1,4925,5066,141
12105,11707,14657,13621,20,7,1914,2950,1036
12107,703,1496,1206,53,19,503,793,290
12109,3382,3951,3580,14,9,198,569,371
12111,5573,6843,6872,19,0,1299,1270,0
12113,1540,1829,1843,16,0,303,289,0
12115,6173,7428,7270,17,2,1097,1255,158
12117,6786,8672,7264,22,16,478,1886,1408
12119,607,878,642,31,27,35,271,236
12121,641,1225,795,48,35,154,583,429
12123,260,496,353,48,29,93,237,144
12125,141,231,259,39,0,118,90,0
12127,12596,15456,15004,19,3,2408,2860,452
12129,415,888,465,53,48,50,474,424
12131,1116,1628,1377,31,15,261,512,251
12133,282,412,377,31,8,95,130,35
13001,233,497,325,53,34,92,263,171
13003,122,208,170,41,18,48,86,38
13005,160,273,284,41,0,124,113,0
13007,174,273,205,36,25,31,98,67
13009,1742,2573,2084,32,19,342,831,489
13011,171,353,193,51,45,22,182,160
13013,1720,2637,2003,35,24,283,917,634
13015,2397,3397,2785,29,18,388,1000,612
13017,911,1059,1194,14,0,283,147,0
13019,732,850,824,14,3,92,118,26
13021,7335,10254,10689,28,0,3354,2919,0
13023,262,430,320,39,26,58,169,111
13025,112,190,151,41,21,39,79,40
13027,720,837,834,14,0,114,116,2
13029,327,494,387,34,22,60,167,107
13031,3262,4549,3585,28,21,323,1287,964
13033,508,903,844,44,7,336,395,59
13035,432,564,521,23,8,89,132,43
13037,124,195,180,36,7,56,70,14
13039,1613,2092,1923,23,8,310,479,169
13043,216,355,269,39,24,53,139,86
13045,5112,5926,5765,14,3,653,814,161
13047,781,1371,987,43,28,206,589,383
13049,137,233,170,41,27,33,96,63
13051,9880,12605,12995,22,0,3115,2725,0
13053,250,372,256,33,31,6,122,116
13055,281,492,448,43,9,167,212,45
13057,1327,1595,1584,17,1,257,268,11
13059,7387,10063,8767,27,13,1380,2676,1296
13061,65,108,108,40,0,43,43,0
13063,12979,14325,14094,9,2,1115,1346,231
13065,88,150,159,41,0,71,62,0
13067,19924,20488,21370,3,0,1446,564,0
13069,802,1365,1112,41,19,310,564,254
13071,1321,2169,1778,39,18,457,848,391
13073,978,1462,1049,33,28,71,484,413
13075,636,739,702,14,5,66,103,37
13077,3270,4270,4026,23,6,756,1000,244
13079,217,321,282,32,12,65,104,39
13081,787,1310,1103,40,16,316,522,206
13083,151,265,162,43,39,11,114,103
13085,412,640,415,36,35,3,228,225
13087,1213,1900,1497,36,21,284,686,402
13089,26570,31063,31063,14,0,4493,4493,0
13091,452,743,693,39,7,241,291,50
13093,294,489,433,40,11,139,195,56
13095,5767,6867,7280,16,0,1513,1099,0
13097,1776,2581,2168,31,16,392,805,413
13099,426,666,579,36,13,153,241,88
13101,75,128,75,41,41,,53,53
13103,993,1385,1055,28,24,62,392,330
13105,473,680,667,30,2,194,207,13
13107,706,1161,928,39,20,222,455,233
13109,153,325,230,53,29,77,172,95
13111,228,474,295,52,38,67,246,179
13113,1409,1824,1495,23,18,86,415,329
13115,2280,3452,3196,34,7,916,1172,256
13117,572,1318,639,57,52,67,746,679
13119,286,590,460,51,22,174,304,130
13121,35691,49996,50388,29,0,14697,14305,0
13123,362,752,418,52,44,56,390,334
13125,67,119,69,44,42,2,52,50
13127,3266,4236,3923,23,7,657,970,313
13129,855,1775,1081,52,39,226,920,694
13131,923,1445,1072,36,26,149,522,373
13133,368,529,442,30,17,74,161,87
13135,16462,19084,17638,14,8,1176,2622,1446
13137,405,834,607,51,27,202,430,228
13139,4840,6377,5655,24,11,815,1537,722
13141,190,337,228,44,32,38,147,109
13143,473,717,593,34,17,120,243,123
13145,250,416,269,40,35,19,166,147
13147,311,641,475,51,26,164,330,166
13149,265,345,327,23,5,62,80,18
13151,3720,4359,4029,15,8,309,639,330
13153,4032,5380,5060,25,6,1028,1348,320
13155,243,282,376,14,0,133,39,0
13157,1410,2162,1576,35,27,166,752,586
13159,229,333,283,31,15,54,104,50
13161,187,399,295,53,26,108,211,103
13163,446,793,559,44,29,113,347,234
13165,158,282,212,44,25,54,123,69
13167,172,282,217,39,23,45,111,66
13169,390,577,441,32,23,51,186,135
13171,475,619,608,23,2,133,145,12
13173,258,439,287,41,35,29,181,152
13175,1443,2372,1970,39,17,527,929,402
13177,565,672,649,16,4,84,108,24
13179,1189,1795,1658,34,8,469,606,137
13181,131,233,156,44,33,25,102,77
13183,172,259,175,34,33,3,88,85
13185,4324,5766,5227,25,9,903,1442,539
13187,745,1157,769,36,33,24,412,388
13189,615,1093,874,44,20,259,478,219
13191,185,240,196,23,18,11,55,44
13193,216,358,360,40,0,144,143,0
13195,493,710,545,30,23,52,216,164
13197,145,242,190,40,21,45,96,51
13199,520,678,602,23,11,82,158,76
13201,136,212,203,36,5,67,77,10
13205,844,1321,1170,36,11,326,477,151
13207,481,711,625,32,12,144,230,86
13209,113,241,137,53,43,24,128,104
13211,278,404,355,31,12,77,126,49
13213,500,1039,540,52,48,40,539,499
13215,5001,7449,7229,33,3,2228,2448,220
13217,2168,2878,2640,25,8,472,710,238
13219,448,644,451,30,30,3,196,193
13221,160,231,170,30,26,10,70,60
13223,2640,3676,2833,28,23,193,1036,843
13225,703,1039,1034,32,0,331,336,5
13227,379,787,500,52,36,121,408,287
13229,201,343,291,41,15,90,142,52
13231,257,336,266,23,21,9,78,69
13233,794,1202,1086,34,10,292,408,116
13235,238,317,311,25,2,73,79,6
13237,573,846,688,32,19,115,273,158
13239,47,79,47,40,40,,31,31
13241,456,707,520,36,27,64,251,187
13243,115,191,237,40,0,122,76,0
13245,8210,9902,12982,17,0,4772,1692,0
13247,1947,2584,2243,25,13,296,637,341
13249,74,122,95,40,23,21,49,28
13251,224,312,291,28,7,67,88,21
13253,183,287,188,36,34,5,104,99
13255,2381,3106,3096,23,0,715,726,11
13257,281,579,551,51,5,270,298,28
13259,114,189,153,40,19,39,75,36
13261,774,1288,1374,40,0,600,513,0
13263,71,117,105,40,11,34,47,13
13265,47,83,52,44,38,5,36,31
13267,295,627,422,53,33,127,332,205
13269,157,261,241,40,8,84,104,20
13271,282,600,356,53,41,74,318,244
13273,350,548,476,36,13,126,198,72
13275,1711,2810,2157,39,23,446,1099,653
13277,1587,1843,2012,14,0,425,256,0
13279,750,1595,937,53,41,187,845,658
13281,159,247,162,36,34,3,88,85
13283,110,180,174,39,4,64,71,7
13285,2574,3355,3238,23,3,664,781,117
13287,445,517,544,14,0,99,72,0
13289,86,127,90,32,29,4,41,37
13291,444,689,488,36,29,44,245,201
13293,1004,1309,1312,23,0,308,306,0
13295,1100,1930,1391,43,28,291,830,539
13297,1629,2369,2087,31,12,458,740,282
13299,780,1328,1185,41,11,405,548,143
13301,132,235,199,44,15,67,103,36
13303,388,689,559,44,19,171,301,130
13305,447,950,675,53,29,228,503,275
13307,11,18,12,40,34,1,7,6
13309,67,143,94,53,34,27,76,49
13311,807,1253,872,36,30,65,446,381
13313,2006,2305,2190,13,5,184,299,115
13315,117,192,133,39,31,16,75,59
13317,348,618,456,44,26,108,270,162
13319,101,149,141,32,6,40,48,8
13321,427,701,585,39,17,158,274,116
15001,5042,7622,6604,34,13,1562,2580,1018
15003,27529,35121,36305,22,0,8776,7592,0
15005,3,4,3,32,32,,1,1
15007,1113,1639,1818,32,0,705,526,0
15009,3342,4923,4789,32,3,1447,1580,133
16001,8602,10406,10212,17,2,1610,1805,195
16003,34,62,35,45,43,1,28,27
16005,2205,3211,2639,31,18,434,1006,572
16007,93,135,126,31,7,33,42,9
16009,122,185,153,34,17,31,63,32
16011,366,575,457,36,21,91,210,119
16013,308,535,350,42,35,42,227,185
16015,82,149,95,45,36,13,67,54
16017,852,1295,909,34,30,57,443,386
16019,2408,2697,2894,11,0,486,289,0
16021,137,208,150,34,28,13,71,58
16023,30,55,30,45,45,,24,24
16025,14,25,14,42,42,,11,11
16027,3411,5543,4083,38,26,672,2132,1460
16029,47,69,69,31,0,22,22,0
16031,277,420,330,34,21,53,143,90
16033,1,2,1,45,45,,1,1
16035,73,133,83,45,37,10,59,49
16037,34,61,36,45,41,2,27,25
16039,269,468,344,42,26,75,198,123
16041,118,172,139,31,19,21,54,33
16043,83,132,111,37,16,28,49,21
16045,417,465,455,10,2,38,48,10
16047,172,298,188,42,37,16,127,111
16049,158,286,184,45,36,26,128,102
16051,122,193,153,37,21,31,71,40
16053,285,495,356,42,28,71,210,139
16055,1284,2039,1797,37,12,513,755,242
16057,1464,2224,1549,34,30,85,760,675
16059,159,287,193,45,33,34,128,94
16061,59,108,102,45,5,43,48,5
16063,37,64,47,42,27,10,27,17
16065,900,1428,978,37,32,78,528,450
16067,175,304,224,42,26,49,129,80
16069,690,1249,1072,45,14,382,559,177
16071,66,96,71,31,26,5,30,25
16073,93,236,102,61,57,9,143,134
16075,448,500,499,10,0,51,51,0
16077,60,87,75,31,14,15,27,12
16079,266,404,367,34,9,101,138,37
16081,122,194,122,37,37,,72,72
16083,1254,1900,1633,34,14,379,646,267
16085,106,192,112,45,42,6,86,80
16087,252,281,305,10,0,53,29,0
17001,1071,1995,1643,46,18,572,924,352
17003,123,290,374,57,0,251,167,0
17005,133,267,253,50,5,120,134,14
17007,503,640,726,21,0,223,136,0
17009,42,78,114,46,0,72,36,0
17011,718,930,867,23,7,149,212,63
17013,45,92,77,52,17,32,47,15
17015,217,348,261,38,25,44,132,88
17017,175,361,217,52,40,42,186,144
17019,12019,14194,13126,15,8,1107,2175,1068
17021,720,1342,988,46,26,268,622,354
17023,178,301,243,41,19,65,123,58
17025,96,163,197,41,0,101,67,0
17027,255,510,400,50,22,145,255,110
17029,1238,2360,1617,48,31,379,1122,743
17031,197796,265899,254139,26,4,56343,68103,11760
17033,193,327,202,41,38,9,134,125
17035,51,97,97,48,0,46,46,0
17037,7091,7931,7855,11,1,764,840,76
17039,250,465,381,46,18,131,216,85
17041,217,414,220,48,47,3,197,194
17043,13780,16434,16595,16,0,2815,2654,0
17045,244,465,371,48,20,127,221,94
17047,69,162,110,57,32,41,93,52
17049,291,583,607,50,0,316,292,0
17051,170,341,199,50,42,29,171,142
17053,105,190,183,45,4,78,85,7
17055,628,1117,1079,44,3,451,489,38
17057,641,1148,943,44,18,302,508,206
17059,57,135,121,57,10,64,77,13
17061,125,257,238,52,8,113,133,20
17063,452,1197,632,62,47,180,745,565
17065,116,273,146,57,46,30,157,127
17067,199,356,244,44,32,45,157,112
17069,57,135,136,57,0,79,77,0
17071,65,117,88,44,25,23,52,29
17073,540,967,909,44,6,369,428,59
17075,376,681,402,45,41,26,305,279
17077,2926,5207,3734,44,28,808,2281,1473
17079,75,127,97,41,24,22,52,30
17081,449,929,871,52,6,422,480,58
17083,209,431,433,52,0,224,222,0
17085,232,372,338,38,9,106,141,35
17087,96,225,172,57,24,76,130,54
17089,8710,12369,11082,30,10,2372,3659,1287
17091,2648,3871,3471,32,10,823,1223,400
17093,591,1566,796,62,49,205,975,770
17095,1704,2206,2270,23,0,566,503,0
17097,11233,17318,15726,35,9,4493,6085,1592
17099,1936,3004,2753,36,8,817,1068,251
17101,190,321,268,41,17,78,132,54
17103,429,689,632,38,8,203,260,57
17105,366,663,604,45,9,238,297,59
17107,682,1270,862,46,32,180,589,409
17109,1002,1796,1295,44,28,293,794,501
17111,3179,5011,3956,37,21,777,1832,1055
17113,5183,8035,6370,35,21,1187,2852,1665
17115,3380,5280,4849,36,8,1469,1900,431
17117,523,1079,729,52,32,206,556,350
17119,6639,10806,8471,39,22,1832,4167,2335
17121,469,970,860,52,11,391,502,111
17123,176,228,200,23,12,24,52,28
17125,214,399,316,46,21,102,185,83
17127,207,487,368,57,24,161,280,119
17129,145,270,280,46,0,135,125,0
17131,140,251,182,44,27,42,111,69
17133,229,473,231,52,51,2,245,243
17135,322,644,477,50,26,155,322,167
17137,535,1104,946,52,14,411,569,158
17139,164,306,175,46,43,11,142,131
17141,494,802,777,38,3,283,309,26
17143,5857,8000,8185,27,0,2328,2143,0
17145,264,470,442,44,6,178,206,28
17147,149,277,182,46,34,33,128,95
17149,184,342,294,46,14,110,159,49
17151,40,95,92,57,3,52,54,2
17153,98,231,175,57,24,77,133,56
17155,96,125,97,23,22,1,28,27
17157,303,627,424,52,32,121,324,203
17159,156,263,277,41,0,121,108,0
17161,4228,5447,6684,22,0,2456,1219,0
17163,7131,10999,10776,35,2,3645,3868,223
17165,469,1104,792,57,28,323,634,311
17167,5874,8069,7704,27,5,1830,2195,365
17169,66,123,74,46,40,8,57,49
17171,34,70,71,52,0,37,36,0
17173,227,422,309,46,27,82,196,114
17175,57,74,75,23,0,18,17,0
17177,817,1328,1167,38,12,350,510,160
17179,1684,3670,2585,54,30,901,1986,1085
17181,301,709,481,57,32,180,407,227
17183,1253,2269,2252,45,1,999,1015,16
17185,109,255,173,57,32,64,147,83
17187,263,472,381,44,19,118,209,91
17189,89,184,96,52,48,7,95,88
17191,173,293,328,41,0,155,120,0
17193,163,384,234,57,39,71,221,150
17195,876,1407,1216,38,14,340,532,192
17197,6861,10867,8749,37,19,1888,4006,2118
17199,1594,2837,2337,44,18,743,1243,500
17201,8305,12190,11136,32,9,2831,3886,1055
17203,529,685,698,23,0,169,156,0
18001,501,595,683,16,0,182,93,0
18003,9740,12853,12390,24,4,2650,3113,463
18005,1288,1730,1903,26,0,615,442,0
18007,198,214,209,8,2,11,16,5
18009,220,442,321,50,27,101,222,121
18011,523,743,674,30,9,151,220,69
18013,269,363,283,26,22,14,94,80
18015,363,392,372,8,5,9,30,21
18017,637,1001,891,36,11,254,363,109
18019,1999,3637,3156,45,13,1157,1638,481
18021,414,927,606,55,35,192,512,320
18023,808,874,897,8,0,89,66,0
18025,70,178,127,61,29,57,108,51
18027,532,739,798,28,0,266,206,0
18029,780,1120,952,30,15,172,340,168
18031,245,380,365,35,4,120,134,14
18033,502,818,534,39,35,32,317,285
18035,5210,7147,6220,27,13,1010,1937,927
18037,352,895,547,61,39,195,543,348
18039,2754,4626,3744,40,19,990,1872,882
18041,521,801,701,35,12,180,280,100
18043,1795,3079,2827,42,8,1032,1284,252
18045,266,595,289,55,51,23,329,306
18047,218,314,235,30,25,17,95,78
18049,214,493,284,57,42,70,279,209
18051,334,501,518,33,0,184,168,0
18053,1351,1995,1983,32,1,632,644,12
18055,673,934,909,28,3,236,261,25
18057,1024,2131,1319,52,38,295,1107,812
18059,1021,1291,1125,21,13,104,270,166
18061,501,859,570,42,34,69,358,289
18063,2195,2264,2335,3,0,140,69,0
18065,766,1537,1120,50,27,354,771,417
18067,2457,3858,3376,36,13,919,1402,483
18069,725,860,823,16,4,98,135,37
18071,795,1068,1037,26,3,242,273,31
18073,209,480,268,57,44,59,272,213
18075,250,502,281,50,44,31,252,221
18077,339,525,573,35,0,234,186,0
18079,222,344,245,35,29,23,122,99
18081,3203,3563,3614,10,0,411,360,0
18083,601,1529,1119,61,27,518,928,410
18085,1055,1296,1188,19,8,133,242,109
18087,341,556,376,39,32,35,215,180
18089,13760,20169,18251,32,10,4491,6409,1918
18091,2905,3993,3529,27,12,624,1088,464
18093,1206,1674,1484,28,11,278,468,190
18095,3455,4133,4534,16,0,1079,678,0
18097,44983,55472,52391,19,6,7408,10489,3081
18099,585,720,739,19,0,154,134,0
18101,168,233,177,28,24,9,65,56
18103,545,805,740,32,8,195,260,65
18105,8439,10362,9526,19,8,1087,1923,836
18107,1030,1114,1431,8,0,401,84,0
18109,1375,1858,1717,26,8,342,483,141
18111,100,231,117,57,49,17,131,114
18113,606,989,808,39,18,202,383,181
18115,96,137,101,30,27,5,42,37
18117,469,651,567,28,13,98,182,84
18119,461,640,511,28,20,50,179,129
18121,150,335,240,55,28,90,185,95
18123,158,401,356,61,11,198,243,45
18125,92,234,141,61,40,49,142,93
18127,2461,2953,2712,17,8,251,492,241
18129,170,255,273,33,0,103,85,0
18131,88,202,91,57,55,3,114,111
18133,509,688,659,26,4,150,179,29
18135,428,858,493,50,43,65,431,366
18137,299,430,349,30,19,50,131,81
18139,231,355,284,35,20,53,124,71
18141,7429,9426,10030,21,0,2601,1997,0
18143,248,384,370,35,4,122,136,14
18145,775,980,921,21,6,146,205,59
18147,142,362,221,61,39,79,220,141
18149,174,400,185,57,54,11,226,215
18151,384,626,544,39,13,160,242,82
18153,407,911,508,55,44,101,503,402
18155,125,180,128,30,29,3,55,52
18157,9669,10837,10970,11,0,1301,1168,0
18159,210,330,216,36,35,6,120,114
18161,108,165,134,35,19,26,58,32
18163,5704,7365,7294,23,1,1590,1661,71
18165,291,651,384,55,41,93,360,267
18167,2245,2876,3167,22,0,922,631,0
18169,545,805,674,32,16,129,260,131
18171,108,241,114,55,53,6,133,127
18173,571,857,674,33,21,103,286,183
18175,369,634,419,42,34,50,264,214
18177,1584,2434,2192,35,10,608,850,242
18179,566,672,665,16,1,99,106,7
18181,524,566,567,8,0,43,43,0
18183,540,641,581,16,9,41,101,60
19001,55,109,97,50,11,42,54,12
19003,31,61,56,50,9,25,30,5
19005,222,302,246,26,18,24,80,56
19007,175,347,284,50,18,109,172,63
19009,32,64,50,50,21,18,32,14
19011,151,269,223,44,17,72,118,46
19013,3777,4364,4987,13,0,1210,587,0
19015,733,977,853,25,13,120,244,124
19017,311,423,408,26,3,97,112,15
19019,364,391,400,7,0,36,27,0
19021,190,393,279,52,29,89,203,114
19023,76,211,85,64,60,9,135,126
19025,83,171,110,52,36,27,89,62
19027,235,487,417,52,14,182,252,70
19029,319,517,424,38,18,105,198,93
19031,238,346,285,31,18,47,108,61
19033,1088,2197,1565,50,29,477,1108,631
19035,124,258,199,52,23,75,133,58
19037,263,357,287,26,20,24,94,70
19039,104,207,162,50,22,58,103,45
19041,228,353,381,35,0,153,125,0
19043,342,465,374,26,19,32,123,91
19045,1261,1830,1548,31,15,287,569,282
19047,142,294,251,52,15,109,152,43
19049,747,969,905,23,7,158,222,64
19051,67,107,90,38,17,23,41,18
19053,134,267,208,50,22,74,132,58
19055,279,300,369,7,0,90,21,0
19057,890,1288,1362,31,0,472,398,0
19059,223,344,296,35,14,73,121,48
19061,3087,3316,3753,7,0,666,229,0
19063,122,188,161,35,15,39,66,27
19065,453,616,521,26,15,68,162,94
19067,299,604,468,50,22,169,305,136
19069,75,208,118,64,43,43,133,90
19071,122,198,176,38,11,54,76,22
19073,99,205,152,52,26,53,106,53
19075,43,119,55,64,54,12,76,64
19077,88,175,161,50,8,73,87,14
19079,149,415,204,64,51,55,266,211
19081,130,261,146,50,44,16,132,116
19083,120,332,158,64,53,38,213,175
19085,298,483,510,38,0,212,185,0
19087,462,668,548,31,18,86,206,120
19089,223,304,248,26,18,25,80,55
19091,78,217,87,64,60,9,139,130
19093,38,78,81,52,0,43,40,0
19095,133,237,134,44,43,1,104,103
19097,527,566,717,7,0,190,39,0
19099,756,1044,959,28,8,203,288,85
19101,276,445,422,38,5,146,169,23
19103,8694,9719,9714,11,0,1020,1025,5
19105,278,403,365,31,10,87,125,38
19107,76,123,120,38,2,44,47,3
19109,165,332,249,50,25,84,168,84
19111,719,1040,1064,31,0,345,321,0
19113,3220,5206,4480,38,14,1260,1986,726
19115,163,235,180,31,24,17,73,56
19117,105,208,183,50,12,78,103,25
19119,46,71,98,35,0,52,25,0
19121,156,215,214,28,1,58,59,1
19123,360,580,498,38,14,138,221,83
19125,401,553,615,28,0,214,152,0
19127,466,830,632,44,24,166,364,198
19129,158,256,259,38,0,101,98,0
19131,109,221,135,50,39,26,111,85
19133,95,197,164,52,17,69,102,33
19135,81,161,139,50,14,58,80,22
19137,256,415,364,38,12,108,159,51
19139,1035,1502,1468,31,2,433,467,34
19141,169,260,242,35,7,73,92,19
19143,61,95,80,35,15,19,33,14
19145,283,459,451,38,2,168,176,8
19147,106,164,168,35,0,62,58,0
19149,126,407,288,69,29,162,281,119
19151,52,108,62,52,42,10,56,46
19153,11205,16104,13551,30,16,2346,4900,2554
19155,2755,4467,3737,38,16,982,1712,730
19157,255,454,380,44,16,125,199,74
19159,31,61,79,50,0,48,30,0
19161,65,135,119,52,12,54,70,16
19163,3853,5271,4823,27,8,970,1418,448
19165,205,332,269,38,19,64,127,63
19167,185,286,301,35,0,116,101,0
19169,6208,8278,6542,25,21,334,2070,1736
19171,174,310,185,44,40,11,136,125
19173,65,130,86,50,33,21,64,43
19175,234,466,343,50,26,109,231,122
19177,52,83,57,38,32,5,32,27
19179,532,859,926,38,0,394,326,0
19181,502,693,702,28,0,200,191,0
19183,296,477,373,38,22,77,181,104
19185,43,86,56,50,34,13,43,30
19187,407,1130,804,64,29,397,723,326
19189,164,331,206,50,38,42,167,125
19191,460,625,538,26,14,78,165,87
19193,1195,3856,2288,69,41,1093,2661,1568
19195,80,162,107,50,34,27,82,55
19197,93,260,129,64,50,36,166,130
20001,210,524,330,60,37,120,315,195
20003,93,234,118,60,49,25,140,115
20005,151,249,328,39,0,177,98,0
20007,65,91,80,28,12,15,26,11
20009,608,845,787,28,7,179,238,59
20011,183,459,346,60,25,163,276,113
20013,204,319,274,36,14,70,116,46
20015,687,917,989,25,0,302,230,0
20017,53,73,61,28,17,8,21,13
20019,70,98,77,28,21,7,27,20
20021,215,422,286,49,32,71,206,135
20023,24,55,41,56,26,17,31,14
20025,20,29,22,32,25,2,9,7
20027,109,160,147,32,8,38,51,13
20029,130,191,167,32,13,37,61,24
20031,188,261,200,28,23,12,73,61
20033,31,43,38,28,12,7,12,5
20035,1101,1531,1313,28,14,212,429,217
20037,988,1933,1407,49,27,419,946,527
20039,26,60,49,56,18,23,34,11
20041,265,390,352,32,10,87,125,38
20043,62,103,77,39,25,15,40,25
20045,6832,8433,7494,19,11,662,1601,939
20047,67,93,79,28,15,12,26,14
20049,44,60,58,28,5,14,17,3
20051,423,970,618,56,36,195,547,352
20053,67,99,83,32,16,16,32,16
20055,367,540,542,32,0,175,172,0
20057,276,405,462,32,0,186,129,0
20059,411,1028,620,60,40,209,618,409
20061,832,948,1039,12,0,207,116,0
20063,9,20,9,56,56,,11,11
20065,17,38,27,56,30,10,21,11
20067,79,116,91,32,22,12,37,25
20069,31,46,31,32,32,,15,15
20071,4,10,5,56,47,1,6,5
20073,170,236,198,28,16,28,66,38
20075,13,18,15,32,21,2,6,4
20077,118,164,150,28,9,32,46,14
20079,781,1170,1129,33,3,348,388,40
20081,23,34,28,32,17,5,11,6
20083,12,18,17,32,4,5,6,1
20085,115,180,171,36,5,56,65,9
20087,104,171,129,39,25,25,67,42
20089,23,34,33,32,2,10,11,1
20091,8740,11362,10514,23,7,1774,2622,848
20093,10,15,18,32,0,8,5,0
20095,91,127,93,28,27,2,36,34
20097,72,101,88,28,12,16,28,12
20099,323,632,488,49,23,165,309,144
20101,6,15,11,56,23,5,8,3
20103,856,1411,1287,39,9,431,554,123
20105,24,35,37,32,0,13,11,0
20107,83,209,116,60,44,33,125,92
20109,19,43,38,56,12,19,24,5
20111,1515,2105,1671,28,21,156,589,433
20113,402,655,544,39,17,142,253,111
20115,209,290,237,28,18,28,81,53
20117,102,150,130,32,13,28,48,20
20119,40,59,44,32,25,4,19,15
20121,376,942,601,60,36,225,566,341
20123,64,95,90,32,5,26,30,4
20125,597,1168,886,49,24,289,571,282
20127,110,153,121,28,21,11,43,32
20129,34,50,35,32,30,1,16,15
20131,111,163,149,32,9,38,52,14
20133,251,490,376,49,23,125,240,115
20135,12,27,17,56,38,5,15,10
20137,39,88,49,56,45,10,50,40
20139,182,285,247,36,13,65,103,38
20141,21,48,50,56,0,29,27,0
20143,53,78,84,32,0,31,25,0
20145,108,150,121,28,19,13,42,29
20147,25,57,50,56,13,25,32,7
20149,266,304,313,12,0,47,37,0
20151,267,372,309,28,17,42,105,63
20153,13,30,22,56,26,9,17,8
20155,1571,2558,1911,39,25,340,987,647
20157,38,57,53,32,6,15,18,3
20159,156,255,214,39,16,58,98,40
20161,2824,3217,3113,12,3,289,393,104
20163,46,105,59,56,44,13,59,46
20165,83,115,91,28,21,8,32,24
20167,60,138,100,56,27,40,78,38
20169,1245,1832,1623,32,11,378,587,209
20171,9,20,11,56,46,2,11,9
20173,15406,19469,18529,21,5,3123,4062,939
20175,254,372,340,32,9,86,119,33
20177,5386,8111,7289,34,10,1903,2725,822
20179,15,35,19,56,45,4,20,16
20181,87,198,127,56,36,40,112,72
20183,16,37,42,56,0,26,21,0
20185,39,54,53,28,2,14,15,1
20187,6,9,16,32,0,10,3,0
20189,53,77,56,32,28,3,25,22
20191,428,596,594,28,0,166,168,2
20193,87,200,120,56,40,33,113,80
20195,11,25,20,56,21,9,14,5
20197,28,44,33,36,25,5,16,11
20199,4,10,9,56,5,5,6,1
20201,32,48,61,32,0,29,15,0
20203,7,17,7,56,56,,10,10
20205,155,215,192,28,11,37,60,23
20207,80,111,81,28,27,1,31,30
20209,5499,9081,8525,39,6,3026,3582,556
21001,333,469,430,29,8,97,136,39
21003,279,566,421,51,26,142,287,145
21005,414,554,466,25,16,52,141,89
21007,53,195,83,73,57,30,142,112
21009,1062,2152,1531,51,29,469,1090,621
21011,266,536,360,50,33,94,270,176
21013,377,927,1195,59,0,818,550,0
21015,2756,3191,3610,14,0,854,435,0
21017,374,642,753,42,0,379,269,0
21019,762,1548,1555,51,0,793,786,0
21021,886,1436,1256,38,13,370,550,180
21023,149,301,214,50,29,65,152,87
21025,258,623,358,59,43,100,365,265
21027,132,209,240,37,0,108,77,0
21029,1162,1614,1501,28,7,339,452,113
21031,175,355,295,51,17,120,180,60
21033,235,364,327,35,10,92,129,37
21035,576,2118,729,73,66,153,1542,1389
21037,2460,4551,3686,46,19,1226,2091,865
21039,14,50,32,73,37,18,37,19
21041,325,602,454,46,25,129,276,147
21043,259,527,425,51,19,166,267,101
21045,276,388,373,29,4,97,112,15
21047,1956,2638,2748,26,0,792,682,0
21049,654,1124,1322,42,0,668,470,0
21051,337,667,494,50,26,157,330,173
21053,170,240,257,29,0,87,69,0
21055,139,216,163,35,24,24,76,52
21057,117,165,184,29,0,67,48,0
21059,2854,3652,3999,22,0,1145,798,0
21061,219,444,286,51,36,67,225,158
21063,50,101,119,51,0,69,52,0
21065,240,449,378,46,16,138,208,70
21067,11029,14177,14025,22,1,2996,3148,152
21069,228,458,308,50,33,80,231,151
21071,397,1468,877,73,40,480,1070,590
21073,1965,2633,2469,25,6,504,668,164
21075,87,319,279,73,13,192,232,40
21077,189,349,197,46,44,8,160,152
21079,368,597,488,38,18,120,228,108
21081,503,930,649,46,30,146,427,281
21083,379,1394,687,73,51,308,1015,707
21085,239,379,367,37,3,128,140,12
21087,273,384,399,29,0,126,111,0
21089,394,801,614,51,23,220,407,187
21091,112,143,192,22,0,80,31,0
21093,1326,2241,1797,41,20,471,915,444
21095,258,635,597,59,6,339,377,38
21097,313,538,520,42,3,207,225,18
21099,345,700,475,51,32,130,355,225
21101,1234,2142,2035,42,5,801,909,108
21103,521,684,662,24,3,141,163,22
21105,43,158,73,73,54,30,115,85
21107,926,1433,1377,35,4,451,507,56
21109,275,546,423,50,22,148,270,122
21111,29791,42493,39632,30,7,9841,12702,2861
21113,1339,2170,1648,38,24,309,831,522
21115,210,776,444,73,43,234,566,332
21117,5924,8030,7746,26,4,1822,2106,284
21119,141,340,193,59,43,52,199,147
21121,508,1249,1086,59,13,578,741,163
21123,54,327,209,83,36,155,273,118
21125,1243,2462,1575,50,36,332,1219,887
21127,137,279,219,51,21,82,142,60
21129,116,279,211,59,25,95,163,68
21131,112,270,143,59,47,31,158,127
21133,282,680,405,59,40,123,398,275
21135,187,377,259,50,31,72,190,118
21137,547,886,663,38,25,116,339,223
21139,81,125,84,35,33,3,44,41
21141,548,1110,767,51,31,219,562,343
21143,46,62,101,26,0,55,16,0
21145,788,2898,1954,73,33,1166,2110,944
21147,649,959,738,32,23,89,310,221
21149,107,186,201,42,0,94,79,0
21151,1825,3406,2426,46,29,601,1581,980
21153,116,427,171,73,60,55,311,256
21155,73,444,300,83,32,227,370,143
21157,158,581,394,73,32,236,423,187
21159,108,400,262,73,34,154,292,138
21161,398,801,602,50,25,204,404,200
21163,262,414,317,37,24,55,153,98
21165,157,315,179,50,43,22,159,137
21167,610,817,761,25,7,151,207,56
21169,98,199,167,51,16,69,101,32
21171,234,475,334,51,30,100,241,141
21173,708,1427,884,50,38,176,718,542
21175,246,496,267,50,46,21,250,229
21177,444,687,614,35,11,170,243,73
21179,207,1255,565,83,55,358,1048,690
21181,58,100,104,42,0,46,42,0
21183,339,590,442,42,25,103,250,147
21185,802,1053,890,24,15,88,250,162
21187,234,433,263,46,39,29,199,170
21189,37,90,37,59,59,,53,53
21191,228,422,319,46,24,91,194,103
21193,479,1155,657,59,43,178,676,498
21195,674,2490,1193,73,52,519,1816,1297
21197,307,573,388,46,32,81,266,185
21199,2369,3498,2804,32,20,435,1130,695
21201,48,96,48,50,50,,48,48
21203,288,570,392,50,31,104,282,178
21205,732,1473,958,50,35,226,742,516
21207,421,592,563,29,5,142,172,30
21209,576,990,1061,42,0,485,414,0
21211,967,1280,1265,24,1,298,312,14
21213,374,757,445,51,41,71,384,313
21215,104,145,172,28,0,68,41,0
21217,692,975,1097,29,0,405,282,0
21219,169,228,254,26,0,85,59,0
21221,166,223,242,26,0,76,58,0
21223,126,165,163,24,1,37,39,2
21225,281,488,389,42,20,108,207,99
21227,3100,4506,4141,31,8,1041,1406,365
21229,36,219,113,83,48,77,183,106
21231,658,972,813,32,16,155,314,159
21233,220,382,294,42,23,74,162,88
21235,413,1016,959,59,6,546,603,57
21237,168,406,242,59,40,74,237,163
21239,499,669,709,25,0,210,170,0
22001,730,1710,1416,57,17,686,980,294
22003,347,650,541,47,17,194,303,109
22005,1537,2234,1846,31,17,309,697,388
22007,335,389,351,14,10,16,54,38
22009,567,1243,844,54,32,277,676,399
22011,525,983,688,47,30,163,458,295
22013,335,513,459,35,11,124,178,54
22015,2088,2948,2852,29,3,764,860,96
22017,7202,10342,10061,30,3,2859,3140,281
22019,3781,7816,6648,52,15,2867,4034,1167
22021,256,476,369,46,22,113,219,106
22023,8,17,18,54,0,10,9,0
22025,47,102,131,54,0,84,56,0
22027,333,511,476,35,7,143,177,34
22029,252,553,427,54,23,175,301,126
22031,574,879,820,35,7,246,305,59
22033,17170,20051,20963,14,0,3793,2881,0
22035,389,723,596,46,17,207,333,126
22037,297,559,299,47,46,2,262,260
22039,890,1465,1395,39,5,505,575,70
22041,609,1130,743,46,34,134,521,387
22043,169,371,282,54,24,113,202,89
22045,1403,2347,2162,40,8,759,944,185
22047,428,804,599,47,26,171,376,205
22049,482,896,654,46,27,172,413,241
22051,12802,15890,15881,19,0,3079,3088,9
22053,360,778,544,54,30,184,417,233
22055,4521,8879,6666,49,25,2145,4358,2213
22057,2272,2639,2810,14,0,538,367,0
22059,76,167,128,54,23,52,91,39
22061,2025,3101,2499,35,19,474,1076,602
22063,1924,2609,2067,26,21,143,685,542
22065,491,911,605,46,34,114,420,306
22067,846,1571,1011,46,36,165,725,560
22069,1732,2653,2358,35,11,626,920,294
22071,21985,29958,31034,27,0,9049,7973,0
22073,5460,7257,8053,25,0,2593,1797,0
22075,488,531,518,8,2,30,43,13
22077,271,510,344,47,32,73,239,166
22079,2910,3781,4082,23,0,1172,872,0
22081,128,196,221,35,0,93,68,0
22083,457,848,618,46,27,161,391,230
22085,368,564,626,35,0,258,196,0
22087,1141,1242,1343,8,0,202,100,0
22089,569,958,765,41,20,196,389,193
22091,138,187,151,26,19,13,49,36
22093,157,264,375,41,0,218,107,0
22095,510,859,824,41,4,314,349,35
22097,1970,3245,3100,39,4,1130,1275,145
22099,543,909,963,40,0,420,366,0
22101,1107,1851,1422,40,23,315,745,430
22103,2734,4139,3345,34,19,611,1405,794
22105,2793,3747,3335,25,11,542,955,413
22107,163,303,182,46,40,19,140,121
22109,1583,2135,2105,26,1,522,552,30
22111,407,756,534,46,29,127,349,222
22113,516,1208,978,57,19,462,692,230
22115,886,1152,1060,23,8,174,265,91
22117,788,1058,1071,25,0,283,269,0
22119,717,1013,1186,29,0,469,296,0
22121,488,917,561,47,39,73,429,356
22123,324,601,383,46,36,59,277,218
22125,147,277,176,47,36,29,130,101
22127,166,365,267,54,27,101,198,97
23001,2897,4967,4633,42,7,1736,2070,334
23003,1358,2763,2160,51,22,802,1405,603
23005,8843,12129,13163,27,0,4320,3286,0
23007,722,1209,861,40,29,139,486,347
23009,715,1524,1149,53,25,434,809,375
23011,5301,6701,6552,21,2,1251,1400,149
23013,468,997,758,53,24,290,529,239
23015,223,475,400,53,16,177,252,75
23017,1179,1972,1656,40,16,477,793,316
23019,4552,6452,6272,29,3,1720,1900,180
23021,302,505,391,40,23,89,203,114
23023,508,539,917,6,0,409,30,0
23025,1080,1807,1347,40,25,267,727,460
23027,429,915,554,53,39,125,486,361
23029,434,883,637,51,28,203,449,246
23031,2389,4047,4011,41,1,1622,1658,36
24001,2204,3722,3212,41,14,1008,1519,511
24003,4733,7664,7824,38,0,3091,2931,0
24005,18242,25858,24501,29,5,6259,7616,1357
24009,1143,1855,1464,38,21,321,711,390
24011,594,1043,812,43,22,218,449,231
24013,1438,1935,2309,26,0,871,497,0
24015,3592,4827,4264,26,12,672,1235,563
24017,1444,2423,2412,40,0,968,979,11
24019,1064,1867,1538,43,18,474,804,330
24021,3060,5153,4562,41,11,1502,2093,591
24023,679,1148,805,41,30,126,468,342
24025,2483,4713,4274,47,9,1791,2230,439
24027,3178,3767,4207,16,0,1029,589,0
24029,401,704,536,43,24,135,303,168
24031,15215,22588,22537,33,0,7322,7373,51
24033,22364,30013,27905,25,7,5541,7649,2108
24035,593,1040,711,43,32,118,448,330
24037,1482,2403,2234,38,7,752,922,170
24039,593,1008,852,41,15,259,414,155
24041,1012,1776,1212,43,32,200,764,564
24043,3253,4343,5122,25,0,1869,1090,0
24045,2769,4703,3647,41,22,878,1934,1056
24047,779,1323,996,41,25,217,544,327
24510,30568,53516,53934,43,0,23366,22948,0
25001,3000,5918,4549,49,23,1549,2918,1369
25003,4501,8186,6747,45,18,2246,3685,1439
25005,16510,28410,24596,42,13,8086,11900,3814
25007,186,275,283,32,0,97,89,0
25009,26277,42262,38764,38,8,12487,15985,3498
25011,1609,2904,2538,45,13,929,1295,366
25013,19080,34932,29911,45,14,10831,15852,5021
25015,4321,7264,5384,41,26,1063,2943,1880
25017,35475,63843,55183,44,14,19708,28368,8660
25019,144,212,153,32,28,9,69,60
25021,14221,24301,20224,41,17,6003,10080,4077
25023,8086,12875,12996,37,0,4910,4789,0
25025,37014,74640,71004,50,5,33990,37626,3636
25027,21137,36764,31024,43,16,9887,15628,5741
26001,62,110,82,44,26,20,48,28
26003,82,135,133,40,2,51,53,2
26005,1203,1869,1526,36,18,323,666,343
26007,399,710,664,44,6,265,310,45
26009,281,450,294,38,35,13,169,156
26011,131,259,184,49,29,53,128,75
26013,124,178,162,31,9,38,54,16
26015,535,760,646,30,15,111,225,114
26017,2176,3089,3242,30,0,1066,913,0
26019,148,302,178,51,41,30,154,124
26021,5172,7714,6725,33,13,1553,2542,989
26023,494,875,642,44,27,148,381,233
26025,3072,4367,3986,30,9,914,1295,381
26027,509,1099,801,54,27,292,590,298
26029,294,471,412,38,13,118,177,59
26031,284,505,387,44,23,103,221,118
26033,656,1085,980,40,10,324,429,105
26035,748,906,910,17,0,162,158,0
26037,996,1174,1174,15,0,178,178,0
26039,188,334,253,44,24,65,146,81
26041,599,991,899,40,9,300,392,92
26043,532,766,681,31,11,149,234,85
26045,1928,2272,2469,15,0,541,344,0
26047,531,850,634,38,25,103,320,217
26049,13913,18506,17050,25,8,3137,4594,1457
26051,216,425,376,49,12,160,210,50
26053,426,613,586,31,4,160,187,27
26055,1163,2379,1581,51,34,418,1216,798
26057,1070,1297,1348,17,0,278,226,0
26059,533,943,781,43,17,248,409,161
26061,1256,1809,1531,31,15,275,552,277
26063,488,573,630,15,0,142,85,0
26065,15149,19749,18043,23,9,2894,4600,1706
26067,848,1428,1206,41,16,358,580,222
26069,203,401,285,49,29,82,198,116
26071,179,258,299,31,0,120,79,0
26073,3883,4703,4249,17,10,366,820,454
26075,5512,6990,6812,21,3,1300,1478,178
26077,7817,11934,10194,34,15,2377,4117,1740
26079,197,316,244,38,23,47,119,72
26081,16375,20756,20739,21,0,4364,4381,17
26083,16,22,16,31,31,,7,7
26085,160,237,262,33,0,102,77,0
26087,1421,1595,1810,11,0,389,174,0
26089,190,389,209,51,46,19,199,180
26091,1429,2526,1774,43,30,345,1098,753
26093,2144,2857,2390,25,16,246,713,467
26095,80,131,109,40,17,29,52,23
26097,154,254,178,40,30,24,100,76
26099,16366,21096,20846,22,1,4480,4730,250
26101,290,593,424,51,29,134,303,169
26103,1860,2678,2507,31,6,647,818,171
26105,584,867,679,33,22,95,282,187
26107,853,1437,1106,41,23,253,584,331
26109,294,486,518,40,0,224,192,0
26111,1767,2509,2195,30,13,428,742,314
26113,159,254,168,38,34,9,96,87
26115,2188,3615,3026,39,16,838,1427,589
26117,763,1285,1060,41,18,297,522,225
26119,101,179,143,44,20,42,78,36
26121,3015,5168,4124,42,20,1109,2153,1044
26123,611,906,736,33,19,125,295,170
26125,23731,31067,29748,24,4,6017,7336,1319
26127,366,543,429,33,21,63,177,114
26129,224,441,264,49,40,40,217,177
26131,94,135,132,31,2,38,41,3
26133,271,456,404,41,11,133,185,52
26135,97,172,120,44,30,23,75,52
26137,262,465,353,44,24,91,204,113
26139,3670,4330,4148,15,4,478,660,182
26141,75,133,166,44,0,91,58,0
26143,331,653,382,49,41,51,322,271
26145,3987,6710,5481,41,18,1494,2723,1229
26147,4481,6220,5710,28,8,1229,1739,510
26149,710,1259,1026,44,18,316,549,233
26151,628,738,787,15,0,159,110,0
26153,83,137,175,40,0,92,54,0
26155,1261,1560,1533,19,2,272,299,27
26157,834,980,894,15,9,60,145,85
26159,1131,2444,1408,54,42,277,1313,1036
26161,16114,19764,19008,18,4,2894,3650,756
26163,74071,99737,94743,26,5,20672,25666,4994
26165,496,794,751,38,5,255,299,44
27001,239,366,351,35,4,112,127,15
27003,4289,6436,5874,33,9,1585,2147,562
27005,620,1160,862,47,26,242,540,298
27007,1103,2064,1401,47,32,298,961,663
27009,1177,1438,1515,18,0,338,261,0
27011,81,118,132,32,0,51,38,0
27013,2298,3323,2947,31,11,649,1025,376
27015,261,591,455,56,23,194,331,137
27017,721,1105,919,35,17,198,384,186
27019,280,1677,597,83,64,317,1397,1080
27021,513,786,635,35,19,122,274,152
27023,163,371,287,56,22,124,207,83
27025,448,949,645,53,32,197,501,304
27027,1598,2684,2210,40,18,612,1087,475
27029,167,313,219,47,30,52,146,94
27031,135,207,150,35,27,15,72,57
27033,124,254,225,51,11,101,129,28
27035,807,1584,1267,49,20,460,776,316
27037,7495,11430,9594,34,16,2099,3935,1836
27039,258,370,390,30,0,132,112,0
27041,720,1056,991,32,6,271,336,65
27043,206,421,313,51,26,107,215,108
27045,178,398,268,55,33,90,220,130
27047,720,1033,966,30,6,246,313,67
27049,423,1233,874,66,29,451,810,359
27051,82,121,127,32,0,45,38,0
27053,32028,55540,48272,42,13,16244,23512,7268
27055,139,310,268,55,14,129,172,43
27057,325,609,452,47,26,127,284,157
27059,311,658,481,53,27,170,347,177
27061,858,1316,1199,35,9,341,458,117
27063,103,210,164,51,22,61,107,46
27065,163,345,253,53,27,90,182,92
27067,736,1793,1127,59,37,391,1057,666
27069,40,67,87,40,0,47,27,0
27071,485,743,703,35,5,218,258,40
27073,38,85,88,56,0,50,48,0
27075,291,445,352,35,21,61,154,93
27077,35,66,65,47,1,30,31,1
27079,176,511,333,66,35,157,336,179
27081,36,83,77,56,6,41,46,5
27083,381,865,705,56,18,324,483,159
27085,458,1116,743,59,33,285,658,373
27087,116,217,139,47,36,23,101,78
27089,87,146,159,40,0,72,59,0
27091,383,783,548,51,30,165,400,235
27093,248,604,376,59,38,128,356,228
27095,327,693,482,53,30,155,366,211
27097,301,590,554,49,6,253,289,36
27099,1344,1927,1705,30,12,361,584,223
27101,97,199,133,51,33,36,102,66
27103,661,955,936,31,2,275,295,20
27105,344,704,462,51,34,118,359,241
27107,83,140,148,40,0,65,57,0
27109,3029,4317,4242,30,2,1213,1288,75
27111,877,1287,1258,32,2,381,410,29
27113,265,445,426,40,4,161,180,19
27115,261,552,376,53,32,115,291,176
27117,134,273,226,51,17,92,140,48
27119,738,1241,1237,40,0,499,502,3
27121,110,161,181,32,0,71,51,0
27123,18216,26919,28551,32,0,10335,8703,0
27125,39,66,95,40,0,56,27,0
27127,159,360,231,56,36,72,201,129
27129,157,383,269,59,30,112,226,114
27131,460,1340,979,66,27,519,880,361
27133,153,312,226,51,28,73,159,86
27135,203,341,302,40,11,99,138,39
27137,3677,7430,6597,51,11,2920,3753,833
27139,1597,2008,2102,20,0,505,411,0
27141,1471,1796,1804,18,0,333,325,0
27143,130,318,213,59,33,83,187,104
27145,5222,6442,6390,19,1,1168,1220,52
27147,930,1335,1185,30,11,255,404,149
27149,193,283,305,32,0,112,90,0
27151,112,164,220,32,0,108,52,0
27153,176,345,363,49,0,187,169,0
27155,43,63,67,32,0,24,20,0
27157,186,417,302,55,27,116,231,115
27159,199,390,346,49,11,147,191,44
27161,278,402,428,31,0,150,124,0
27163,1879,4046,2952,54,27,1073,2167,1094
27165,126,257,196,51,24,70,131,61
27167,58,85,132,32,0,74,27,0
27169,707,1583,1128,55,29,421,876,455
27171,2553,3999,2900,36,27,347,1446,1099
27173,87,196,155,56,21,68,110,42
28001,602,1257,1249,52,1,647,655,8
28003,349,938,794,63,15,445,590,145
28005,121,253,176,52,30,55,132,77
28007,374,658,547,43,17,173,283,110
28009,58,157,59,63,62,1,99,98
28011,1069,1582,1586,32,0,517,513,0
28013,219,450,268,51,40,49,231,182
28015,73,128,110,43,14,37,55,18
28017,255,523,442,51,16,187,268,81
28019,151,214,192,29,10,41,62,21
28021,101,211,129,52,39,28,110,82
28023,108,254,181,58,29,73,146,73
28025,669,945,1020,29,0,351,276,0
28027,598,1369,1288,56,6,690,771,81
28029,330,712,470,54,34,140,382,242
28031,31,126,76,76,40,45,95,50
28033,1442,1856,1817,22,2,375,414,39
28035,3440,5012,4410,31,12,970,1573,603
28037,88,184,119,52,35,31,96,65
28039,161,247,230,35,7,69,86,17
28041,20,82,35,76,57,15,62,47
28043,642,1128,967,43,14,325,486,161
28045,787,1206,1135,35,6,348,419,71
28047,5452,7609,7789,28,0,2337,2157,0
28049,7749,11525,11736,33,0,3987,3776,0
28051,316,556,550,43,1,234,240,6
28053,267,395,378,32,4,111,128,17
28055,24,35,39,32,0,15,11,0
28057,235,483,300,51,38,65,248,183
28059,3085,4435,4449,30,0,1364,1350,0
28061,96,261,123,63,53,27,165,138
28063,101,210,248,52,0,147,110,0
28065,34,141,88,76,38,54,107,53
28067,218,899,764,76,15,546,681,135
28069,114,310,201,63,35,87,196,109
28071,1028,2111,1270,51,40,242,1083,841
28073,1841,2682,1996,31,26,155,841,686
28075,955,2253,2139,58,5,1184,1298,114
28077,79,166,127,52,23,48,86,38
28079,184,502,330,63,34,146,318,172
28081,1600,2992,2605,47,13,1005,1392,387
28083,1291,2268,2016,43,11,725,978,253
28085,353,736,667,52,9,314,383,69
28087,2934,4145,4064,29,2,1130,1211,81
28089,1888,2755,2464,31,11,576,868,292
28091,420,612,523,31,15,103,192,89
28093,251,676,468,63,31,217,425,208
28095,374,767,718,51,6,344,394,50
28097,253,445,373,43,16,120,192,72
28099,280,764,458,63,40,178,484,306
28101,129,305,263,58,14,134,176,42
28103,343,484,452,29,7,109,141,32
28105,3562,5033,4104,29,18,542,1471,929
28107,354,812,486,56,40,132,457,325
28109,742,1137,962,35,15,220,395,175
28111,90,131,123,31,6,33,41,8
28113,664,1386,1311,52,5,647,722,75
28115,231,432,327,47,24,96,201,105
28117,220,593,388,63,35,168,373,205
28119,155,355,236,56,34,81,200,119
28121,1117,2053,1408,46,31,291,936,645
28123,212,578,323,63,44,111,366,255
28125,121,180,173,32,3,52,58,6
28127,130,239,194,46,19,64,109,45
28129,68,186,98,63,47,30,118,88
28131,181,278,215,35,22,34,96,62
28133,684,1012,1073,32,0,389,328,0
28135,129,294,214,56,27,85,166,81
28137,376,862,461,56,46,85,486,401
28139,160,430,262,63,39,102,270,168
28141,147,396,280,63,29,133,249,116
28143,336,770,433,56,44,97,434,337
28145,407,762,517,47,32,110,354,244
28147,77,161,130,52,19,53,84,31
28149,1335,2881,1972,54,32,637,1546,909
28151,1963,2905,2627,32,10,664,942,278
28153,42,171,150,76,13,108,130,22
28155,306,433,348,29,20,42,127,85
28157,124,260,196,52,24,72,135,63
28159,572,808,755,29,7,183,236,53
28161,203,358,311,43,13,108,154,46
28163,678,1151,1115,41,3,437,473,36
29001,1058,1654,1249,36,24,191,596,405
29003,360,460,412,22,11,52,100,48
29005,51,76,83,33,0,32,25,0
29007,495,717,731,31,0,236,222,0
29009,448,687,460,35,33,12,239,227
29011,178,284,241,37,15,63,106,43
29013,332,492,372,32,24,40,160,120
29015,302,402,339,25,16,37,100,63
29017,141,192,167,27,13,26,51,25
29019,8450,9316,9484,9,0,1034,866,0
29021,3622,4634,4453,22,4,831,1012,181
29023,1182,1604,1594,26,1,412,422,10
29025,188,242,260,22,0,72,53,0
29027,172,660,415,74,37,243,488,245
29029,400,662,424,40,36,24,262,238
29031,1702,2318,2322,27,0,620,616,0
29033,60,97,122,38,0,62,37,0
29035,110,150,116,26,22,6,39,33
29037,1575,2331,2142,32,8,567,756,189
29039,233,372,297,37,20,64,139,75
29041,45,72,66,38,9,21,27,6
29043,1107,1531,1164,28,24,57,424,367
29045,78,123,125,36,0,47,44,0
29047,3789,4675,5343,19,0,1554,887,0
29049,362,464,472,22,0,110,103,0
29051,453,1738,1135,74,35,682,1285,603
29053,141,226,226,38,0,85,86,1
29055,337,673,436,50,35,99,336,237
29057,84,134,87,37,35,3,50,47
29059,196,261,231,25,11,35,65,30
29061,67,100,109,33,0,42,33,0
29063,276,353,362,22,0,86,77,0
29065,228,455,339,50,25,111,227,116
29067,213,410,219,48,47,6,198,192
29069,668,1362,1165,51,14,497,694,197
29071,750,2258,1065,67,53,315,1508,1193
29073,131,260,148,50,43,17,130,113
29075,59,89,81,33,9,22,30,8
29077,8268,11223,9885,26,12,1617,2955,1338
29079,138,207,202,33,2,64,69,5
29081,76,114,149,33,0,73,38,0
29083,370,589,526,37,11,156,220,64
29085,161,214,181,25,15,20,53,33
29087,48,72,59,33,18,11,24,13
29089,108,174,167,38,4,59,66,7
29091,922,1778,1270,48,29,348,856,508
29093,221,300,247,26,18,26,79,53
29095,23963,37160,33731,36,9,9768,13197,3429
29097,4078,5657,4921,28,13,843,1579,736
29099,2481,5367,3424,54,36,943,2886,1943
29101,1801,2312,1937,22,16,136,511,375
29103,73,115,97,36,15,24,41,17
29105,817,1086,1008,25,7,191,269,78
29107,580,745,818,22,0,238,165,0
29109,557,888,682,37,23,125,331,206
29111,124,193,139,36,28,15,70,55
29113,942,1365,1277,31,6,335,423,88
29115,178,267,284,33,0,106,89,0
29117,230,345,349,33,0,119,115,0
29119,322,495,382,35,23,60,172,112
29121,270,422,337,36,20,67,152,85
29123,231,313,271,26,14,40,82,42
29125,79,157,99,50,37,20,78,58
29127,648,1012,1027,36,0,379,365,0
29129,36,54,60,33,0,24,18,0
29131,280,463,308,40,33,28,183,155
29133,251,512,501,51,2,250,261,11
29135,68,260,88,74,66,20,192,172
29137,100,156,114,36,27,14,56,42
29139,292,423,340,31,20,48,131,83
29141,158,262,189,40,28,31,103,72
29143,328,669,628,51,6,300,341,41
29145,1137,1578,1263,28,20,126,441,315
29147,654,983,789,33,20,135,328,193
29149,167,322,263,48,18,96,155,59
29151,33,127,44,74,65,11,94,83
29153,146,282,199,48,29,53,136,83
29155,440,896,978,51,0,538,457,0
29157,307,410,364,25,11,57,103,46
29159,685,1102,959,38,13,274,417,143
29161,935,1866,1268,50,32,333,931,598
29163,435,630,527,31,16,92,195,103
29165,1390,1608,1633,14,0,243,217,0
29167,799,1062,822,25,23,23,263,240
29169,674,1115,772,40,31,98,441,343
29171,73,110,122,33,0,49,37,0
29173,147,230,156,36,32,9,83,74
29175,284,457,503,38,0,219,173,0
29177,385,494,587,22,0,202,109,0
29179,94,127,100,26,22,6,33,27
29181,323,438,363,26,17,40,115,75
29183,4631,5406,5429,14,0,798,775,0
29185,118,188,172,37,9,54,70,16
29186,214,285,278,25,3,64,72,8
29187,1461,1953,1805,25,8,344,491,147
29189,23126,29865,30231,23,0,7105,6739,0
29195,330,530,553,38,0,223,201,0
29197,60,94,101,36,0,41,34,0
29199,32,50,73,36,0,41,18,0
29201,772,1052,1299,27,0,527,280,0
29203,130,251,154,48,39,24,121,97
29205,98,153,126,36,18,28,55,27
29207,430,876,651,51,26,221,446,225
29209,421,646,457,35,29,36,225,189
29211,99,148,110,33,26,11,50,39
29213,1158,1777,1300,35,27,142,619,477
29215,392,757,584,48,23,192,364,172
29217,344,549,498,37,9,154,205,51
29219,765,1108,987,31,11,222,343,121
29221,309,413,479,25,0,170,104,0
29223,360,489,394,26,19,34,129,95
29225,417,576,488,28,15,71,160,89
29227,17,25,17,33,33,,8,8
29229,381,735,673,48,8,292,354,62
29510,23278,32666,32374,29,1,9096,9388,292
30001,196,404,258,51,36,62,208,146
30003,74,293,107,75,64,33,219,186
30005,79,118,118,33,0,39,39,0
30007,44,90,50,51,45,6,46,40
30009,87,107,129,19,0,42,20,0
30011,2,9,2,75,75,,7,7
30013,1528,2276,2477,33,0,949,748,0
30015,60,90,71,33,21,11,29,18
30017,101,402,173,75,57,72,301,229
30019,10,40,11,75,72,1,30,29
30021,68,272,108,75,60,40,203,163
30023,146,300,287,51,4,141,154,13
30025,15,60,17,75,72,2,45,43
30027,207,308,253,33,18,46,101,55
30029,2422,3574,2784,32,22,362,1152,790
30031,1897,2328,2255,19,3,358,431,73
30033,2,9,2,75,75,,7,7
30035,175,258,202,32,22,27,83,56
30037,2,10,3,75,65,1,7,6
30039,45,93,48,51,48,3,48,45
30041,295,440,509,33,0,214,145,0
30043,81,167,110,51,34,29,86,57
30045,7,10,14,33,0,7,3,0
30047,529,814,602,35,26,73,285,212
30049,1106,2277,1854,51,19,748,1172,424
30051,17,25,29,33,0,12,8,0
30053,288,425,362,32,15,74,137,63
30055,10,39,10,75,75,,29,29
30057,90,186,94,51,49,4,96,92
30059,16,24,16,33,33,,8,8
30061,78,120,82,35,32,4,42,38
30063,3510,5403,4318,35,20,808,1892,1084
30065,30,121,60,75,50,30,90,60
30067,164,202,245,19,0,81,37,0
30069,6,9,6,33,33,,3,3
30071,13,51,46,75,10,33,38,5
30073,67,99,82,33,18,15,33,18
30075,2,7,2,75,75,,5,5
30077,57,118,75,51,36,18,61,43
30079,6,25,10,75,59,4,19,15
30081,662,1018,752,35,26,90,357,267
30083,94,375,155,75,59,61,281,220
30085,65,257,85,75,67,20,192,172
30087,44,176,46,75,74,2,132,130
30089,157,242,181,35,25,24,85,61
30091,18,73,40,75,45,22,55,33
30093,794,1635,1243,51,24,449,841,392
30095,63,77,69,19,11,6,14,8
30097,21,26,25,19,3,4,5,1
30099,55,81,64,33,22,9,27,18
30101,63,94,88,33,6,25,31,6
30103,2,8,5,75,38,3,6,3
30105,65,258,136,75,47,71,193,122
30107,0,0,4,0,0,4,0,0
30109,6,25,6,75,75,,19,19
30111,2788,5324,4127,48,22,1339,2536,1197
31001,431,811,719,47,11,288,380,92
31003,58,131,92,56,30,34,74,40
31005,2,3,2,51,51,,2,2
31007,4,6,4,36,36,,2,2
31009,9,13,9,29,29,,4,4
31011,15,35,45,56,0,30,19,0
31013,188,294,280,36,5,92,105,13
31015,10,15,17,36,0,7,5,0
31017,44,69,57,36,17,13,25,12
31019,751,1413,1102,47,22,351,663,312
31021,65,147,98,56,34,33,82,49
31023,71,146,92,51,37,21,75,54
31025,154,303,211,49,30,57,149,92
31027,63,143,82,56,43,19,80,61
31029,18,37,28,51,24,10,19,9
31031,48,74,66,36,12,18,27,9
31033,131,205,194,36,5,63,74,11
31035,45,85,59,47,30,14,40,26
31037,79,180,101,56,44,22,101,79
31039,84,191,129,56,33,45,107,62
31041,142,199,229,29,0,87,58,0
31043,380,864,560,56,35,180,484,304
31045,154,240,199,36,17,45,86,41
31047,164,337,353,51,0,189,173,0
31049,19,29,28,36,5,9,11,2
31051,54,123,76,56,38,22,69,47
31053,429,846,686,49,19,257,417,160
31055,17114,22298,21980,23,1,4866,5184,318
31057,5,10,13,51,0,8,5,0
31059,50,103,62,51,40,12,53,41
31061,14,25,30,47,0,16,12,0
31063,8,17,19,51,0,11,9,0
31065,27,54,63,51,0,36,28,0
31067,320,658,482,51,27,162,338,176
31069,4,6,11,36,0,7,2,0
31071,24,33,51,29,0,27,10,0
31073,7,14,10,51,30,3,7,4
31075,1,2,1,51,51,,1,1
31077,21,30,25,29,16,4,9,5
31079,1672,2354,2214,29,6,542,682,140
31081,162,229,187,29,18,25,66,41
31083,24,45,38,47,16,14,21,7
31085,6,12,7,51,43,1,6,5
31087,15,31,20,51,35,5,16,11
31089,67,104,106,36,0,39,37,0
31091,1,3,1,51,51,,1,1
31093,86,121,107,29,12,21,35,14
31095,86,177,110,51,38,24,91,67
31097,54,111,66,51,41,12,57,45
31099,48,91,72,47,20,24,43,19
31101,51,104,83,51,21,32,53,21
31103,3,4,3,36,36,,2,2
31105,44,69,51,36,26,7,25,18
31107,74,168,122,56,27,48,94,46
31109,10175,14223,12290,28,14,2115,4048,1933
31111,280,575,730,51,0,450,295,0
31113,1,3,1,51,51,,1,1
31115,4,5,4,29,29,,1,1
31117,1,2,1,51,51,,1,1
31119,525,1195,864,56,28,339,669,330
31121,185,261,209,29,20,24,76,52
31123,39,61,59,36,3,20,22,2
31125,47,107,66,56,38,19,60,41
31127,94,194,140,51,28,46,100,54
31129,34,64,52,47,19,18,30,12
31131,231,475,312,51,34,81,244,163
31133,23,47,44,51,6,21,24,3
31135,13,27,19,51,29,6,14,8
31137,102,192,156,47,19,54,90,36
31139,45,102,56,56,45,11,57,46
31141,277,629,429,56,32,152,352,200
31143,42,86,53,51,39,11,44,33
31145,96,197,185,51,6,89,101,12
31147,86,177,135,51,24,49,91,42
31149,3,5,17,36,0,14,2,0
31151,232,477,270,51,43,38,245,207
31153,2020,2838,2525,29,11,505,818,313
31155,116,228,172,49,25,56,112,56
31157,583,909,891,36,2,308,326,18
31159,176,361,224,51,38,48,186,138
31161,60,93,73,36,22,13,33,20
31163,21,30,33,29,0,12,9,0
31165,7,11,7,36,36,,4,4
31167,32,72,39,56,46,7,40,33
31169,38,79,49,51,37,11,41,30
31171,2,4,2,51,51,,2,2
31173,52,119,72,56,39,20,67,47
31175,98,138,137,29,1,39,40,1
31177,134,263,207,49,22,73,130,57
31179,86,195,109,56,44,23,109,86
31181,22,42,55,47,0,33,20,0
31183,4,5,4,29,29,,1,1
31185,170,349,307,51,12,137,179,42
32001,462,696,515,34,26,53,234,181
32003,54221,61851,62274,12,0,8053,7630,0
32005,1048,1410,1176,26,17,128,362,234
32007,828,1248,859,34,31,31,420,389
32009,37,56,37,34,34,,19,19
32011,5,7,5,34,34,,2,2
32013,246,371,253,34,32,7,125,118
32015,108,162,133,34,18,25,55,30
32017,99,150,119,34,20,20,50,30
32019,1247,1678,1312,26,22,65,431,366
32021,107,161,116,34,28,9,54,45
32023,1416,2135,1499,34,30,83,719,636
32027,98,148,98,34,34,,50,50
32029,10,13,13,26,3,3,3,0
32031,18567,22050,21284,16,3,2717,3483,766
32033,219,330,221,34,33,2,111,109
32510,1948,2622,2369,26,10,421,674,253
33001,737,1290,1207,43,6,470,554,84
33003,633,1111,841,43,24,208,478,270
33005,903,2015,1540,55,24,637,1112,475
33007,1018,1256,1512,19,0,494,238,0
33009,2296,2832,2767,19,2,471,536,65
33011,8574,12598,13057,32,0,4483,4024,0
33013,3161,4619,4489,32,3,1328,1458,130
33015,3928,6174,5533,36,10,1605,2247,642
33017,3528,6268,5171,44,17,1643,2740,1097
33019,442,986,879,55,11,437,544,107
34001,8951,12010,12728,25,0,3777,3059,0
34003,19508,28669,26102,32,9,6594,9161,2567
34005,4962,7196,5845,31,19,883,2234,1351
34007,16411,22321,23295,26,0,6884,5910,0
34009,2422,3243,2968,25,8,546,821,275
34011,4978,6936,7356,28,0,2378,1959,0
34013,39358,58169,60401,32,0,21043,18811,0
34015,4121,6069,6435,32,0,2314,1948,0
34017,29585,40456,44190,27,0,14605,10871,0
34019,2128,2721,2555,22,6,427,593,166
34021,9974,16221,15207,39,6,5233,6247,1014
34023,21267,28659,27860,26,3,6593,7392,799
34025,12487,18463,18246,32,1,5759,5976,217
34027,5174,6967,7343,26,0,2169,1793,0
34029,9138,13447,12608,32,6,3470,4309,839
34031,24040,31994,32113,25,0,8073,7954,0
34033,1878,2372,2737,21,0,859,493,0
34035,4031,5907,5342,32,10,1311,1876,565
34037,1672,2550,2319,34,9,647,878,231
34039,15286,19764,20993,23,0,5707,4478,0
34041,1741,2152,2781,19,0,1040,411,0
35001,22633,28865,28195,22,2,5562,6232,670
35003,24,42,27,43,36,3,18,15
35005,1643,2238,2010,27,10,367,594,227
35006,545,792,666,31,16,121,247,126
35007,121,280,245,57,13,124,159,35
35009,487,1126,858,57,24,371,640,269
35011,9,22,40,57,0,31,12,0
35013,3799,4815,4714,21,2,915,1016,101
35015,1067,1344,1388,21,0,321,277,0
35017,461,809,772,43,5,311,348,37
35019,20,46,103,57,0,83,26,0
35021,2,4,2,57,57,,2,2
35023,78,136,148,43,0,70,59,0
35025,1459,1837,1812,21,1,353,378,25
35027,300,408,323,27,21,23,108,85
35028,266,369,322,28,13,56,103,47
35029,404,709,706,43,0,302,305,3
35031,996,1447,1279,31,12,283,451,168
35033,33,46,45,28,2,12,13,1
35035,1499,2041,1688,27,17,189,542,353
35037,51,117,163,57,0,112,67,0
35039,472,655,673,28,0,201,183,0
35041,240,555,295,57,47,55,315,260
35043,436,1101,563,60,49,127,665,538
35045,1302,2230,1642,42,26,340,928,588
35047,832,1153,1063,28,8,231,322,91
35049,4470,5238,5569,15,0,1099,768,0
35051,175,307,349,43,0,174,132,0
35053,199,349,315,43,10,116,150,34
35055,862,1195,1168,28,2,306,333,27
35057,145,255,200,43,21,55,110,55
35059,28,65,45,57,31,17,37,20
35061,1979,2534,2173,22,14,194,555,361
36001,8303,13615,12614,39,7,4311,5312,1001
36003,664,1100,744,40,32,80,436,356
36005,99759,160342,173576,38,0,73817,60583,0
36007,6330,8193,7556,23,8,1226,1863,637
36009,1182,1960,1599,40,18,417,778,361
36011,1071,1774,1668,40,6,597,704,107
36013,3241,4117,4387,21,0,1146,876,0
36015,2167,3553,2989,39,16,822,1386,564
36017,1260,1663,1532,24,8,272,403,131
36019,2517,3064,3178,18,0,661,547,0
36021,483,1051,946,54,10,463,568,105
36023,1660,3093,1971,46,36,311,1433,1122
36025,1274,1681,1557,24,7,283,407,124
36027,8512,10328,10906,18,0,2394,1816,0
36029,31313,42478,42879,26,0,11566,11165,0
36031,1092,1329,1264,18,5,172,237,65
36033,1231,1498,1722,18,0,491,267,0
36035,1145,1633,1497,30,8,352,488,136
36037,481,1446,1035,67,28,554,965,411
36039,443,964,645,54,33,202,521,319
36041,43,52,62,18,0,19,9,0
36043,1568,2462,2090,36,15,522,893,371
36045,1987,2925,3056,32,0,1069,938,0
36047,137378,211053,217565,35,0,80187,73675,0
36049,260,382,374,32,2,114,122,8
36051,1088,1729,1467,37,15,379,640,261
36053,475,885,1016,46,0,541,410,0
36055,27765,34966,35282,21,0,7517,7201,0
36057,1020,1455,1523,30,0,503,435,0
36059,16917,24982,24416,32,2,7499,8065,566
36061,76253,134864,134166,43,1,57913,58611,698
36063,5463,9219,7922,41,14,2459,3756,1297
36065,5654,8966,8314,37,7,2660,3312,652
36067,14347,19503,19071,26,2,4724,5155,431
36069,1915,2995,2647,36,12,732,1080,348
36071,9946,13567,13314,27,2,3368,3621,253
36073,279,840,540,67,36,261,561,300
36075,1868,3332,2793,44,16,925,1464,539
36077,1596,2264,1802,29,20,206,668,462
36079,1845,2178,2147,15,1,302,333,31
36081,92953,115204,114752,19,0,21799,22251,452
36083,4217,5511,6222,23,0,2005,1294,0
36085,8734,16612,15241,47,8,6507,7878,1371
36087,8160,10065,12521,19,0,4361,1905,0
36089,3133,4104,3986,24,3,853,971,118
36091,2477,3866,3720,36,4,1243,1389,146
36093,5443,7576,7804,28,0,2361,2133,0
36095,700,993,941,29,5,241,293,52
36097,157,267,208,41,22,51,110,59
36099,394,661,513,40,22,119,267,148
36101,1791,3004,2443,40,19,652,1214,562
36103,24626,34033,32076,28,6,7450,9407,1957
36105,857,1934,1629,56,16,772,1076,304
36107,480,653,631,27,3,151,174,23
36109,5315,5893,6289,10,0,974,578,0
36111,5556,6571,7143,15,0,1587,1016,0
36113,1204,1817,1595,34,12,391,613,222
36115,865,1305,1023,34,22,158,440,282
36117,1133,1902,1815,40,5,682,769,87
36119,27132,38487,41612,30,0,14480,11355,0
36121,690,1095,858,37,22,168,406,238
36123,374,585,469,36,20,95,211,116
37001,3867,5650,5325,32,6,1458,1783,325
37003,661,1051,724,37,31,63,390,327
37005,240,392,348,39,11,108,152,44
37007,692,953,902,27,5,210,260,50
37009,833,958,978,13,0,145,124,0
37011,633,727,753,13,0,120,94,0
37013,755,1397,1200,46,14,445,643,198
37015,151,443,263,66,41,112,292,180
37017,1048,1433,1309,27,9,261,386,125
37019,2022,2633,2325,23,12,303,611,308
37021,7094,10308,9388,31,9,2294,3214,920
37023,1785,2813,2211,37,21,426,1028,602
37025,4527,5968,5228,24,12,701,1440,739
37027,2291,3642,2700,37,26,409,1351,942
37029,161,190,191,15,0,30,29,0
37031,1052,1947,1510,46,22,458,896,438
37033,412,829,627,50,24,215,416,201
37035,1486,3369,2117,56,37,631,1883,1252
37037,1044,1755,1340,40,24,296,710,414
37039,349,454,497,23,0,148,105,0
37041,549,647,769,15,0,220,98,0
37043,134,174,197,23,0,63,40,0
37045,2584,4113,3244,37,21,660,1529,869
37047,1571,2149,1983,27,8,412,578,166
37049,2864,5191,3875,45,25,1011,2327,1316
37051,6600,8908,8636,26,3,2036,2308,272
37053,489,576,587,15,0,98,87,0
37055,346,1015,428,66,58,82,669,587
37057,2963,3960,3741,25,6,778,997,219
37059,477,1011,664,53,34,187,534,347
37061,1502,2505,1759,40,30,257,1003,746
37063,11279,14493,14031,22,3,2752,3214,462
37065,1090,1543,1844,29,0,754,453,0
37067,14875,19432,17874,23,8,2999,4557,1558
37069,677,1023,932,34,9,255,346,91
37071,5533,8474,7217,35,15,1684,2941,1257
37073,206,242,227,15,6,21,37,16
37075,65,138,126,53,9,61,73,12
37077,778,1564,1096,50,30,318,786,468
37079,398,506,511,21,0,113,108,0
37081,13520,17947,18126,25,0,4606,4427,0
37083,2115,3678,2865,42,22,750,1563,813
37085,2566,3618,2970,29,18,404,1052,648
37087,1037,2198,1430,53,35,393,1161,768
37089,1217,1893,1658,36,12,441,676,235
37091,726,1263,928,42,26,202,537,335
37093,1117,2297,1301,51,43,184,1180,996
37095,35,103,65,66,37,30,68,38
37097,2689,4685,3667,43,22,978,1995,1017
37099,1035,1396,1214,26,13,179,360,181
37101,2840,8191,3998,65,51,1158,5351,4193
37103,56,140,94,60,33,38,84,46
37105,1299,2182,1817,40,17,518,884,366
37107,702,1750,1715,60,2,1013,1048,35
37109,1636,2621,1920,38,27,284,985,701
37111,815,1284,922,37,28,107,469,362
37113,886,1152,983,23,15,97,266,169
37115,225,476,369,53,23,144,251,107
37117,224,658,540,66,18,316,434,118
37119,31117,37009,37050,16,0,5933,5892,0
37121,465,534,606,13,0,141,69,0
37123,283,619,419,54,32,136,336,200
37125,1007,2198,1354,54,38,347,1191,844
37127,1960,2776,2572,29,7,612,816,204
37129,6323,8243,7956,23,3,1633,1920,287
37131,560,974,800,42,18,240,414,174
37133,1878,3084,2393,39,22,515,1207,692
37135,4706,6270,5271,25,16,565,1564,999
37137,103,190,127,46,33,24,88,64
37139,1423,1675,1949,15,0,526,253,0
37141,650,910,788,29,13,138,260,122
37143,375,442,484,15,0,109,67,0
37145,683,1374,993,50,28,310,691,381
37147,7826,9614,9329,19,3,1503,1788,285
37149,397,628,440,37,30,43,231,188
37151,1870,3833,2760,51,28,890,1963,1073
37153,1164,2394,1729,51,28,565,1230,665
37155,3100,5907,4492,48,24,1392,2807,1415
37157,1914,4420,2347,57,47,433,2506,2073
37159,2516,3954,3484,36,12,968,1438,470
37161,1232,1949,1472,37,24,240,717,477
37163,1652,2755,2044,40,26,392,1103,711
37165,1023,2103,1803,51,14,780,1080,300
37167,700,1373,1004,49,27,304,674,370
37169,627,1449,791,57,45,164,822,658
37171,1445,2361,1898,39,20,453,917,464
37173,173,366,216,53,41,43,193,150
37175,329,511,523,36,0,194,182,0
37177,22,64,61,66,5,39,42,3
37179,2598,3785,3063,31,19,465,1188,723
37181,942,1423,1339,34,6,397,481,84
37183,22548,29732,26626,24,10,4078,7184,3106
37185,337,542,482,38,11,145,205,60
37187,140,411,429,66,0,289,271,0
37189,4819,5537,5014,13,9,195,718,523
37191,3989,6869,5237,42,24,1248,2880,1632
37193,1383,2261,1822,39,19,439,878,439
37195,3531,4495,4433,21,1,902,964,62
37197,592,1255,792,53,37,200,663,463
37199,428,492,590,13,0,162,64,0
38001,17,38,30,56,22,13,21,8
38003,103,320,278,68,13,175,217,42
38005,53,165,71,68,57,18,112,94
38007,1,2,1,56,56,,1,1
38009,45,140,72,68,49,27,95,68
38011,14,31,28,56,11,14,17,3
38013,9,21,9,56,56,,12,12
38015,1277,2541,2069,50,19,792,1264,472
38017,4251,5877,5769,28,2,1518,1626,108
38019,25,44,39,42,10,14,18,4
38021,48,149,109,68,27,61,101,40
38023,4,9,4,56,56,,5,5
38025,8,19,13,56,30,5,11,6
38027,14,44,36,68,17,22,30,8
38029,16,32,39,50,0,23,16,0
38031,38,117,65,68,45,27,79,52
38033,21,47,36,56,24,15,26,11
38035,3135,5378,3976,42,26,841,2243,1402
38037,11,25,22,56,12,11,14,3
38039,16,28,39,42,0,23,11,0
38041,6,13,8,56,41,2,7,5
38043,14,28,25,50,10,11,14,3
38045,20,62,32,68,49,12,42,30
38047,15,30,16,50,46,1,15,14
38049,28,64,53,56,17,25,36,11
38051,16,31,45,50,0,29,15,0
38053,30,69,45,56,34,15,39,24
38055,40,90,56,56,38,16,51,35
38057,49,110,78,56,30,29,62,33
38059,282,561,520,50,7,238,279,41
38061,34,78,52,56,33,18,44,26
38063,12,37,35,68,6,23,25,2
38065,2,6,9,56,0,7,3,0
38067,85,145,158,42,0,73,61,0
38069,49,153,82,68,46,33,104,71
38071,112,347,291,68,16,179,235,56
38073,46,142,90,68,37,44,96,52
38075,4,8,5,56,44,1,5,4
38077,121,375,270,68,28,149,254,105
38079,124,384,231,68,40,107,260,153
38081,25,76,54,68,30,29,52,23
38083,8,25,9,68,64,1,17,16
38085,29,66,34,56,48,5,37,32
38087,2,6,2,56,56,,3,3
38089,229,521,392,56,25,163,292,129
38091,19,33,20,42,39,1,14,13
38093,221,687,570,68,17,349,466,117
38095,27,47,44,42,5,17,19,2
38097,151,259,208,42,20,57,108,51
38099,172,294,258,42,13,86,123,37
38101,642,1459,1112,56,24,470,818,348
38103,29,89,62,68,31,33,60,27
38105,140,319,241,56,24,101,179,78
39001,564,862,838,35,3,274,299,25
39003,2987,4454,4257,33,4,1270,1467,197
39005,722,1192,945,39,21,223,469,246
39007,2070,2673,2883,23,0,813,603,0
39009,3272,4454,4079,27,8,807,1182,375
39011,717,903,876,21,3,159,186,27
39013,1561,2333,2366,33,0,805,773,0
39015,944,1831,1212,48,34,268,887,619
39017,8941,12255,11433,27,7,2492,3314,822
39019,564,713,644,21,10,80,149,69
39021,748,1244,908,40,27,160,495,335
39023,3129,5390,4808,42,11,1679,2261,582
39025,3963,6579,5495,40,16,1532,2616,1084
39027,1072,1640,1515,35,8,443,568,125
39029,2297,3165,3045,27,4,748,868,120
39031,766,1034,1105,26,0,339,268,0
39033,910,1462,1323,38,10,413,552,139
39035,51616,75529,71509,32,5,19893,23913,4020
39037,710,880,954,19,0,244,171,0
39039,540,918,699,41,24,159,379,220
39041,3233,3591,3620,10,0,387,358,0
39043,1031,1853,1703,44,8,672,822,150
39045,3860,4629,4674,17,0,814,769,0
39047,840,1454,1177,42,19,337,614,277
39049,46746,60499,60688,23,0,13942,13753,0
39051,553,831,573,33,31,20,278,258
39053,678,923,849,27,8,171,245,74
39055,777,1148,990,32,14,213,371,158
39057,2825,5736,4022,51,30,1197,2911,1714
39059,1015,1370,1596,26,0,581,355,0
39061,36903,54511,49891,32,8,12988,17608,4620
39063,1917,3153,2512,39,20,595,1236,641
39065,783,1300,918,40,29,135,518,383
39067,197,371,350,47,6,153,174,21
39069,277,471,310,41,34,33,194,161
39071,969,1482,1214,35,18,245,513,268
39073,533,822,809,35,2,276,290,14
39075,425,573,457,26,20,32,148,116
39077,797,1314,1242,39,6,445,518,73
39079,800,1236,1027,35,17,227,435,208
39081,1781,2664,2620,33,2,839,882,43
39083,1182,1487,1494,21,0,312,305,0
39085,3796,5189,4712,27,9,916,1393,477
39087,738,1567,1102,53,30,364,829,465
39089,3663,5296,4853,31,8,1190,1633,443
39091,1003,1667,1332,40,20,329,664,335
39093,8394,11648,11580,28,1,3186,3254,68
39095,17449,26539,23944,34,10,6495,9090,2595
39097,440,772,591,43,23,151,331,180
39099,5986,8387,8426,29,0,2440,2402,0
39101,1598,2011,2046,21,0,448,412,0
39103,2569,2946,3151,13,0,582,377,0
39105,456,620,526,27,15,70,165,95
39107,652,820,738,21,10,86,169,83
39109,921,2310,1762,60,24,841,1389,548
39111,197,240,268,18,0,71,43,0
39113,17538,28763,23144,39,20,5606,11225,5619
39115,309,376,416,18,0,107,67,0
39117,473,594,607,21,0,134,122,0
39119,1772,3322,2917,47,12,1145,1550,405
39121,231,281,276,18,2,45,50,5
39123,987,1283,1129,23,12,142,296,154
39125,234,398,243,41,39,9,164,155
39127,527,988,750,47,24,223,461,238
39129,519,909,1021,43,0,502,390,0
39131,619,955,881,35,8,262,337,75
39133,5520,6701,6638,18,1,1118,1181,63
39135,534,662,696,19,0,162,128,0
39137,298,490,374,39,24,76,192,116
39139,2791,3546,4111,21,0,1320,755,0
39141,1207,2090,1668,42,20,461,883,422
39143,642,1154,966,44,16,324,512,188
39145,1304,2768,2358,53,15,1054,1464,410
39147,1056,1697,1285,38,24,229,641,412
39149,712,884,952,19,0,240,171,0
39151,7785,11168,10759,30,4,2974,3383,409
39153,15798,25658,23196,38,10,7398,9860,2462
39155,5790,7811,7676,26,2,1886,2020,134
39157,1211,2279,1661,47,27,450,1068,618
39159,386,676,662,43,2,276,290,14
39161,366,461,414,21,10,48,95,47
39163,224,346,335,35,3,111,122,11
39165,2169,2888,3075,25,0,906,719,0
39167,1466,1784,1987,18,0,521,319,0
39169,2377,2950,3003,19,0,626,573,0
39171,554,943,608,41,36,54,389,335
39173,3338,4799,3970,30,17,632,1461,829
39175,455,731,512,38,30,57,276,219
40001,302,629,351,52,44,49,327,278
40003,69,88,69,22,22,,19,19
40005,120,178,184,33,0,64,58,0
40007,50,64,50,22,22,,14,14
40009,284,445,442,36,1,158,160,2
40011,292,373,346,22,7,54,81,27
40013,600,892,690,33,23,90,292,202
40015,494,935,609,47,35,115,440,325
40017,620,918,822,32,10,202,298,96
40019,339,609,542,44,11,203,269,66
40021,879,1830,1056,52,42,177,951,774
40023,241,442,475,46,0,234,201,0
40025,35,45,35,22,22,,10,10
40027,5388,6651,6257,19,6,869,1263,394
40029,55,82,102,33,0,47,27,0
40031,2850,4357,3568,35,18,718,1507,789
40033,93,176,119,47,32,26,83,57
40035,178,258,259,31,0,81,80,0
40037,722,1281,1084,44,15,362,559,197
40039,604,946,646,36,32,42,341,299
40041,623,904,638,31,29,15,282,267
40043,53,67,57,22,16,4,15,11
40045,27,34,28,22,19,1,7,6
40047,476,824,660,42,20,184,348,164
40049,145,259,235,44,10,90,115,25
40051,463,955,613,51,36,150,492,342
40053,58,74,59,22,20,1,16,15
40055,70,110,112,36,0,42,40,0
40057,54,84,72,36,15,18,30,12
40059,49,63,49,22,22,,14,14
40061,145,267,205,46,23,60,122,62
40063,120,183,179,34,2,59,63,4
40065,563,880,674,36,23,111,318,207
40067,77,145,161,47,0,84,68,0
40069,106,158,175,33,0,69,52,0
40071,408,707,676,42,4,268,298,30
40073,345,440,363,22,18,18,96,78
40075,159,248,286,36,0,127,90,0
40077,107,197,178,46,10,71,90,19
40079,712,1308,821,46,37,109,596,487
40081,409,708,468,42,34,59,299,240
40083,507,877,703,42,20,196,370,174
40085,40,71,70,44,2,30,31,1
40087,294,605,309,51,49,15,312,297
40089,616,1132,1035,46,9,419,516,97
40091,170,362,186,53,48,16,191,175
40093,181,231,213,22,8,32,50,18
40095,116,173,162,33,6,46,57,11
40097,803,1166,959,31,18,156,363,207
40099,79,142,85,44,40,6,63,57
40101,1038,2204,1732,53,21,694,1166,472
40103,105,182,107,42,41,2,77,75
40105,126,183,192,31,0,66,57,0
40107,178,270,216,34,20,38,93,55
40109,21443,27681,29618,23,0,8175,6238,0
40111,406,862,718,53,17,312,456,144
40113,371,741,710,50,4,339,370,31
40115,698,1013,936,31,8,238,316,78
40117,77,216,104,64,52,27,138,111
40119,2756,4190,3271,34,22,515,1435,920
40121,810,1487,1164,46,22,354,677,323
40123,573,862,759,34,12,186,289,103
40125,1032,1834,1438,44,22,406,802,396
40127,149,273,227,46,17,78,124,46
40129,20,31,28,36,10,8,11,3
40131,885,1566,1129,43,28,244,681,437
40133,356,541,539,34,0,183,185,2
40135,678,1412,832,52,41,154,733,579
40137,902,1706,1012,47,41,110,804,694
40139,467,596,474,22,21,7,129,122
40141,102,193,126,47,35,24,91,67
40143,16873,23766,22645,29,5,5772,6892,1120
40145,529,1066,760,50,29,231,536,305
40147,336,936,696,64,26,360,600,240
40149,138,217,139,36,36,1,78,77
40151,289,370,331,22,10,42,80,38
40153,447,571,483,22,15,36,124,88
41001,277,428,407,35,5,130,151,21
41003,5501,6404,5889,14,8,388,902,514
41005,7044,8311,8346,15,0,1302,1267,0
41007,1061,1528,1229,31,20,168,467,299
41009,872,1257,1127,31,10,255,384,129
41011,1884,2708,2296,30,15,412,824,412
41013,317,448,392,29,12,75,131,56
41015,683,981,745,30,24,62,298,236
41017,5021,5419,5626,7,0,605,398,0
41019,2458,2870,2901,14,0,443,412,0
41021,28,39,32,29,19,4,11,7
41023,85,121,130,29,0,45,35,0
41025,109,154,155,29,0,46,45,0
41027,249,352,318,29,10,69,103,34
41029,6309,7485,7391,16,1,1082,1176,94
41031,260,368,292,29,21,32,107,75
41033,2648,3805,3018,30,21,370,1158,788
41035,1924,2715,2298,29,15,374,791,417
41037,145,204,169,29,17,24,59,35
41039,14040,18208,16170,23,11,2130,4168,2038
41041,1353,1949,1753,31,10,400,596,196
41043,4735,5511,5376,14,2,641,777,136
41045,672,948,916,29,3,244,276,32
41047,9684,12008,12019,19,0,2335,2324,0
41049,140,198,151,29,24,11,58,47
41051,31132,39227,38971,21,1,7839,8095,256
41053,2024,2863,2689,29,6,665,839,174
41055,23,33,31,29,5,8,10,2
41057,558,804,598,31,26,40,246,206
41059,945,1463,1350,35,8,405,517,112
41061,487,753,793,35,0,306,266,0
41063,93,145,132,35,8,39,51,12
41065,414,585,583,29,0,169,171,2
41067,15270,17487,17352,13,1,2082,2217,135
41069,10,14,11,29,22,1,4,3
41071,2259,3195,3030,29,5,771,936,165
42001,1374,1822,1680,25,8,306,448,142
42003,29826,47011,46821,37,0,16995,17185,190
42005,1476,2120,1975,30,7,499,645,146
42007,2745,5570,4932,51,11,2187,2825,638
42009,899,1253,1085,28,13,186,353,167
42011,10882,14884,13409,27,10,2527,4002,1475
42013,2022,4056,3499,50,14,1477,2035,558
42015,688,1423,1096,52,23,408,734,326
42017,9773,12015,12887,19,0,3114,2242,0
42019,2561,4416,3726,42,16,1165,1855,690
42021,2601,4864,3982,47,18,1381,2263,882
42023,71,127,117,44,8,46,56,10
42025,1067,1679,1668,36,1,601,611,10
42027,7118,7375,7650,3,0,532,257,0
42029,7389,9705,9077,24,6,1688,2316,628
42031,688,1413,978,51,31,290,725,435
42033,1100,1971,1589,44,19,489,871,382
42035,724,954,1108,24,0,384,230,0
42037,1774,2072,2037,14,2,263,297,34
42039,2061,3368,2704,39,20,643,1307,664
42041,3318,6121,4412,46,28,1094,2803,1709
42043,6564,9936,9808,34,1,3244,3372,128
42045,16013,20411,20511,22,0,4498,4398,0
42047,364,652,573,44,12,209,288,79
42049,8609,11917,11790,28,1,3181,3308,127
42051,2312,5182,4145,55,20,1833,2870,1037
42053,26,54,32,51,40,6,28,22
42055,1354,2411,1860,44,23,506,1057,551
42057,244,340,266,28,22,22,96,74
42059,561,1211,947,54,22,386,650,264
42061,426,856,692,50,19,266,429,163
42063,2635,3787,3045,30,20,410,1151,741
42065,491,1009,859,51,15,368,518,150
42067,321,554,356,42,36,35,233,198
42069,4868,7723,7635,37,1,2767,2855,88
42071,9837,12590,12209,22,3,2372,2753,381
42073,1648,3186,2771,48,13,1123,1538,415
42075,2897,3688,3804,21,0,907,791,0
42077,9229,12545,12561,26,0,3332,3316,0
42079,6554,12416,10467,47,16,3913,5863,1950
42081,2379,3132,3230,24,0,851,753,0
42083,739,1325,1186,44,10,447,585,138
42085,2273,3252,3586,30,0,1313,979,0
42087,808,1394,1080,42,23,272,586,314
42089,2023,3038,2484,33,18,461,1015,554
42091,14172,17704,17872,20,0,3700,3532,0
42093,227,414,381,45,8,154,187,33
42095,5183,8592,8212,40,4,3029,3409,380
42097,1602,2919,2472,45,15,870,1317,447
42099,605,899,695,33,23,90,294,204
42101,73878,117578,99369,37,15,25491,43700,18209
42103,637,1012,843,37,17,206,375,169
42105,240,430,382,44,11,142,190,48
42107,2001,3314,3043,40,8,1042,1313,271
42109,475,819,576,42,30,101,344,243
42111,1287,1793,1708,28,5,421,506,85
42113,49,102,104,52,0,55,53,0
42115,441,701,615,37,12,174,260,86
42117,577,1193,888,52,26,311,616,305
42119,755,1303,1060,42,19,305,548,243
42121,824,1693,1393,51,18,569,869,300
42123,782,1277,919,39,28,137,495,358
42125,3960,6102,5720,35,6,1760,2142,382
42127,504,802,647,37,19,143,297,154
42129,6287,11208,9847,44,12,3560,4921,1361
42131,452,510,564,11,0,112,58,0
42133,7351,10356,9346,29,10,1995,3005,1010
44001,1160,1758,1626,34,8,466,598,132
44003,4342,6434,6713,33,0,2371,2092,0
44005,2278,3454,3989,34,0,1711,1176,0
44007,21866,38702,38904,44,0,17038,16836,0
44009,735,2345,2004,69,15,1269,1610,341
45001,238,555,478,57,14,240,317,77
45003,3924,4861,4914,19,0,990,936,0
45005,201,387,328,48,15,127,186,59
45007,2592,5173,3951,50,24,1359,2581,1222
45009,322,621,452,48,27,130,299,169
45011,448,864,675,48,22,227,416,189
45013,2932,3621,3663,19,0,731,690,0
45015,3505,4385,3984,20,9,479,880,401
45017,96,201,180,52,11,84,105,21
45019,9781,13416,13774,27,0,3993,3635,0
45021,1408,2427,1785,42,26,377,1018,641
45023,574,989,832,42,16,258,415,157
45025,1167,2067,1471,44,29,304,899,595
45027,513,851,732,40,14,219,338,119
45029,671,1294,893,48,31,222,623,401
45031,1127,2123,1636,47,23,509,995,486
45033,1053,1782,1271,41,29,218,729,511
45035,2675,3635,3409,26,6,734,960,226
45037,418,517,668,19,0,250,100,0
45039,518,700,716,26,0,198,182,0
45041,2553,4806,3732,47,22,1179,2254,1075
45043,1388,2348,1763,41,25,375,961,586
45045,11948,18088,14954,34,17,3006,6141,3135
45047,974,2270,1846,57,19,872,1296,424
45049,284,547,429,48,22,145,263,118
45051,7067,9193,8044,23,12,977,2126,1149
45053,315,390,383,19,2,68,74,6
45055,484,1015,684,52,33,200,530,330
45057,1768,3130,2029,44,35,261,1362,1101
45059,1002,1945,1377,48,29,375,942,567
45061,251,417,389,40,7,138,166,28
45063,6173,7643,7074,19,7,901,1470,569
45065,78,182,143,57,21,65,104,39
45067,1139,1928,1661,41,14,522,788,266
45069,655,1159,920,44,21,265,504,239
45071,791,1363,1238,42,9,447,572,125
45073,1472,2027,1766,27,13,294,554,260
45075,2037,3926,2743,48,30,706,1890,1184
45077,3072,4228,3461,27,18,389,1157,768
45079,11062,14714,15384,25,0,4322,3652,0
45081,248,335,334,26,0,86,87,1
45083,5808,8651,7896,33,9,2088,2843,755
45085,2153,3574,2940,40,18,787,1421,634
45087,704,1212,1083,42,11,379,509,130
45089,460,763,691,40,9,231,303,72
45091,5738,7916,7019,28,11,1281,2178,897
46003,7,18,11,62,39,4,11,7
46005,120,313,382,62,0,262,193,0
46007,41,193,55,79,72,14,153,139
46009,29,75,60,62,20,31,46,15
46011,365,949,601,62,37,236,584,348
46013,667,1402,1023,52,27,356,735,379
46015,41,106,74,62,31,33,65,32
46017,18,87,18,79,79,,69,69
46019,87,154,164,44,0,77,68,0
46021,16,34,17,52,49,1,18,17
46023,58,276,76,79,72,18,217,199
46025,34,71,39,52,45,5,37,32
46027,749,1229,872,39,29,123,480,357
46029,587,1233,788,52,36,201,647,446
46031,32,151,40,79,74,8,119,111
46033,43,76,56,44,27,13,33,20
46035,204,529,436,62,18,232,326,94
46037,104,218,130,52,40,26,114,88
46039,20,43,36,52,15,16,23,7
46041,56,263,58,79,78,2,207,205
46043,13,33,19,62,43,6,20,14
46045,41,86,46,52,47,5,45,40
46047,84,400,185,79,54,101,315,214
46049,39,83,43,52,48,4,43,39
46051,93,195,171,52,12,78,102,24
46053,38,180,74,79,59,36,142,106
46055,8,36,13,79,65,5,28,23
46057,51,108,63,52,41,12,57,45
46059,18,46,36,62,23,18,29,11
46061,7,17,7,62,62,,11,11
46063,6,12,7,44,35,1,5,4
46065,186,879,326,79,63,140,693,553
46067,30,79,43,62,45,13,48,35
46069,5,24,12,79,50,7,19,12
46071,12,58,21,79,63,9,46,37
46073,12,31,16,62,49,4,19,15
46075,10,47,22,79,54,12,37,25
46077,19,49,38,62,23,19,30,11
46079,72,187,173,62,8,101,115,14
46081,373,663,530,44,20,157,290,133
46083,722,1072,812,33,24,90,350,260
46085,13,64,23,79,63,10,50,40
46087,54,88,55,39,38,1,34,33
46089,12,25,14,52,44,2,13,11
46091,44,93,51,52,45,7,49,42
46093,251,446,349,44,22,98,195,97
46095,21,98,27,79,73,6,78,72
46097,7,18,16,62,12,9,11,2
46099,3716,5128,5539,28,0,1823,1412,0
46101,27,70,44,62,37,17,43,26
46103,1372,2442,2772,44,0,1400,1070,0
46105,20,35,71,44,0,51,15,0
46107,28,58,28,52,52,,30,30
46109,142,299,186,52,38,44,157,113
46111,4,10,5,62,51,1,6,5
46113,74,349,74,79,79,,275,275
46115,99,208,145,52,30,46,109,63
46117,22,104,32,79,69,10,82,72
46119,2,12,2,79,79,,9,9
46121,89,422,89,79,79,,333,333
46123,77,364,96,79,74,19,287,268
46125,111,181,130,39,29,19,71,52
46127,230,378,262,39,31,32,148,116
46129,96,203,166,52,18,70,106,36
46135,602,988,898,39,9,296,386,90
46137,32,153,32,79,79,,121,121
47001,1546,2909,2474,47,15,928,1363,435
47003,878,1586,1144,45,28,266,708,442
47005,313,461,369,32,20,56,148,92
47007,138,279,219,51,22,81,142,61
47009,2936,3789,3681,23,3,745,853,108
47011,2849,4026,3506,29,13,657,1177,520
47013,896,1747,1302,49,25,406,851,445
47015,178,304,254,41,16,76,126,50
47017,564,831,728,32,12,164,267,103
47019,1086,1656,1635,34,1,549,570,21
47021,410,791,418,48,47,8,380,372
47023,222,381,344,42,10,122,159,37
47025,501,977,635,49,35,134,476,342
47027,130,175,151,26,14,21,45,24
47029,715,998,1025,28,0,310,283,0
47031,1696,2192,2160,23,1,464,496,32
47033,247,340,279,27,18,32,93,61
47035,758,1280,1036,41,19,278,522,244
47037,23201,33335,31251,30,6,8050,10134,2084
47039,213,345,267,38,23,54,132,78
47041,289,494,442,41,10,153,205,52
47043,721,1390,1316,48,5,595,669,74
47045,893,1232,1265,27,0,372,339,0
47047,327,599,528,45,12,201,272,71
47049,298,504,384,41,24,86,205,119
47051,766,990,991,23,0,225,224,0
47053,846,1167,1315,27,0,469,321,0
47055,500,701,707,29,0,207,201,0
47057,290,404,330,28,18,40,115,75
47059,1232,1878,1602,34,15,370,646,276
47061,114,231,172,51,26,58,117,59
47063,1334,1863,1925,28,0,591,528,0
47065,8114,11019,11312,26,0,3198,2905,0
47067,89,173,143,49,18,54,84,30
47069,573,929,670,38,28,97,356,259
47071,399,646,500,38,23,101,248,147
47073,966,1419,1385,32,2,419,453,34
47075,612,992,792,38,20,180,380,200
47077,452,733,573,38,22,121,281,160
47079,666,982,878,32,11,212,315,103
47081,195,376,236,48,37,41,181,140
47083,205,302,238,32,21,33,97,64
47085,240,354,347,32,2,107,114,7
47087,276,372,316,26,15,40,96,56
47089,591,695,795,15,0,204,104,0
47091,297,453,427,34,6,130,156,26
47093,11886,17268,17720,31,0,5834,5382,0
47095,169,233,296,27,0,127,64,0
47097,543,995,741,45,25,198,451,253
47099,515,723,684,29,5,169,207,38
47101,100,140,165,29,0,65,40,0
47103,671,867,872,23,0,201,196,0
47105,917,1147,1267,20,0,350,230,0
47107,1087,1536,1620,29,0,533,449,0
47109,459,744,530,38,29,71,285,214
47111,419,716,504,41,30,85,297,212
47113,2532,4348,3691,42,15,1159,1816,657
47115,425,861,638,51,26,213,436,223
47117,490,884,739,45,16,249,395,146
47119,1685,3043,2266,45,26,581,1358,777
47121,113,230,167,51,27,54,116,62
47123,1266,1583,1435,20,9,169,317,148
47125,3739,4469,4500,16,0,761,730,0
47127,70,90,71,23,22,1,20,19
47129,183,357,265,49,26,82,174,92
47131,615,848,928,27,0,313,233,0
47133,326,440,381,26,13,55,113,58
47135,117,165,127,29,23,10,47,37
47137,108,146,117,26,20,9,38,29
47139,248,351,274,29,22,26,103,77
47141,2859,3852,3357,26,13,498,992,494
47143,635,1287,885,51,31,250,652,402
47145,1681,2103,2245,20,0,564,422,0
47147,657,1266,999,48,21,342,609,267
47149,5844,7622,7032,23,8,1188,1778,590
47151,400,779,566,49,27,166,380,214
47153,247,501,324,51,35,77,254,177
47155,1377,1620,1633,15,0,256,243,0
47157,34693,41978,44012,17,0,9319,7285,0
47159,415,709,515,41,27,100,294,194
47161,177,212,184,16,13,7,35,28
47163,2508,4048,3931,38,3,1423,1540,117
47165,2154,3361,3008,36,11,854,1207,353
47167,1074,1966,1520,45,23,446,892,446
47169,125,213,173,41,19,48,88,40
47171,260,396,380,34,4,120,136,16
47173,249,469,354,47,24,105,220,115
47175,53,89,74,41,17,21,36,15
47177,771,1317,1142,41,13,371,546,175
47179,3532,4196,4486,16,0,954,664,0
47181,97,136,115,29,15,18,39,21
47183,1172,1727,1370,32,21,198,554,356
47185,360,607,464,41,24,104,248,144
47187,1519,2063,1753,26,15,234,544,310
47189,1165,1845,1617,37,12,452,680,228
48001,980,1234,1223,21,1,243,253,10
48003,29,169,30,83,82,1,140,139
48005,1570,2463,2286,36,7,716,893,177
48007,244,407,324,40,20,80,163,83
48009,51,159,75,68,53,24,108,84
48011,3,5,5,38,0,2,2,0
48013,400,668,548,40,18,148,268,120
48015,341,542,438,37,19,97,201,104
48017,51,112,56,55,50,5,61,56
48019,207,345,208,40,40,1,139,138
48021,875,1593,1172,45,26,297,719,422
48023,31,97,78,68,20,47,66,19
48025,189,316,451,40,0,262,126,0
48027,6685,8676,8355,23,4,1670,1991,321
48029,41870,59099,55806,29,6,13936,17229,3293
48031,168,190,199,11,0,31,21,0
48033,1,2,1,53,53,,1,1
48035,166,265,232,37,13,66,99,33
48037,2023,3322,2940,39,11,917,1299,382
48039,6358,8515,7013,25,18,655,2157,1502
48041,12260,13382,13402,8,0,1142,1122,0
48043,57,337,113,83,66,56,280,224
48045,13,20,17,38,18,4,8,4
48047,77,187,276,59,0,199,109,0
48049,690,1208,1091,43,10,401,518,117
48051,133,292,190,55,35,57,160,103
48053,897,1087,1097,17,0,200,190,0
48055,618,1125,882,45,22,264,507,243
48057,183,375,243,51,35,60,192,132
48059,120,210,182,43,13,62,90,28
48061,8795,14502,13337,39,8,4542,5707,1165
48063,317,361,389,12,0,72,44,0
48065,20,32,24,38,26,4,12,8
48067,428,702,643,39,8,215,274,59
48069,97,157,123,38,21,26,60,34
48071,127,342,137,63,60,10,215,205
48073,757,1363,999,44,27,242,606,364
48075,79,127,155,38,0,76,48,0
48077,35,108,46,68,58,11,74,63
48079,12,26,14,55,47,2,14,12
48081,24,52,41,53,20,17,28,11
48083,126,221,244,43,0,118,95,0
48085,10517,12444,11915,15,4,1398,1927,529
48087,18,29,35,38,0,17,11,0
48089,211,336,261,37,22,50,125,75
48091,2323,3333,2658,30,20,335,1010,675
48093,136,238,219,43,8,83,102,19
48095,7,15,15,53,0,8,8,0
48097,517,882,806,41,9,289,365,76
48099,1504,1822,1736,17,5,232,318,86
48101,12,36,40,68,0,28,25,0
48103,15,90,15,83,83,,74,74
48105,34,73,34,53,53,,39,39
48107,69,153,103,55,33,34,84,50
48109,18,107,34,83,68,16,88,72
48111,93,150,121,38,19,28,57,29
48113,87048,104788,104908,17,0,17860,17740,0
48115,114,243,181,53,25,67,129,62
48117,202,326,410,38,0,208,124,0
48119,90,132,172,32,0,82,42,0
48121,14069,15552,15174,10,2,1105,1483,378
48123,157,303,333,48,0,176,146,0
48125,12,26,26,55,0,14,14,0
48127,78,125,249,38,0,171,48,0
48129,34,55,75,38,0,41,21,0
48131,138,234,280,41,0,142,95,0
48133,245,428,386,43,10,141,184,43
48135,1574,2431,2297,35,6,723,857,134
48137,4,6,4,38,38,,2,2
48139,2179,2962,2545,26,14,366,783,417
48141,16974,25888,24413,34,6,7439,8914,1475
48143,1196,1744,1309,31,25,113,548,435
48145,217,347,358,37,0,141,130,0
48147,404,689,638,41,7,234,285,51
48149,313,571,396,45,31,83,257,174
48151,30,53,70,43,0,40,23,0
48153,113,251,165,55,34,52,137,85
48155,14,42,23,68,47,9,29,20
48157,5039,6121,5889,18,4,850,1082,232
48159,166,243,217,32,11,51,77,26
48161,227,363,306,37,16,79,136,57
48163,129,215,304,40,0,175,86,0
48165,38,221,55,83,75,17,184,167
48167,7959,9610,9619,17,0,1660,1651,0
48169,46,102,79,55,22,33,56,23
48171,675,760,701,11,8,26,85,59
48173,1,3,1,53,53,,2,2
48175,89,172,136,48,21,47,83,36
48177,189,364,341,48,6,152,175,23
48179,256,412,340,38,18,84,157,73
48181,1780,3037,2634,41,13,854,1257,403
48183,1921,2652,2860,28,0,939,731,0
48185,206,454,302,55,33,96,248,152
48187,1082,1566,1606,31,0,524,484,0
48189,413,912,703,55,23,290,500,210
48191,47,75,77,38,0,30,29,0
48193,105,127,142,17,0,37,22,0
48195,41,66,45,38,32,4,25,21
48197,50,158,107,68,32,57,108,51
48199,522,836,607,38,27,85,314,229
48201,129319,156020,150362,17,4,21043,26701,5658
48203,1358,1712,1661,21,3,303,354,51
48205,37,60,42,38,30,5,23,18
48207,61,107,99,43,7,38,46,8
48209,7558,8412,8015,10,5,457,854,397
48211,32,52,33,38,36,1,20,19
48213,1633,2054,1897,21,8,264,422,158
48215,17754,23918,24127,26,0,6373,6164,0
48217,528,844,673,37,20,145,316,171
48219,187,414,267,55,35,80,227,147
48221,837,1221,913,31,25,76,384,308
48223,920,1346,1014,32,25,94,426,332
48225,478,685,728,30,0,250,207,0
48227,523,1112,767,53,31,244,589,345
48229,8,45,8,83,83,,37,37
48231,2046,3248,2481,37,24,435,1202,767
48233,212,341,369,38,0,157,130,0
48235,12,25,12,53,53,,13,13
48237,53,165,60,68,64,7,113,106
48239,129,248,180,48,28,51,119,68
48241,405,979,608,59,38,203,574,371
48243,2,13,2,83,83,,11,11
48245,6591,10484,10904,37,0,4313,3893,0
48247,72,122,126,41,0,54,50,0
48249,270,652,662,59,0,392,382,0
48251,2160,3631,2447,41,33,287,1471,1184
48253,137,240,246,43,0,109,103,0
48255,192,370,299,48,19,107,178,71
48257,2293,2515,2577,9,0,284,222,0
48259,928,1045,978,11,6,50,117,67
48261,7,18,7,59,59,,10,10
48263,13,23,13,43,43,,10,10
48265,1500,1689,1595,11,6,95,189,94
48267,56,119,78,53,34,22,63,41
48269,1,3,1,55,55,,1,1
48271,49,80,72,38,9,23,30,7
48273,491,1183,989,59,16,498,693,195
48275,62,108,103,43,5,41,47,6
48277,1587,2321,1960,32,16,373,734,361
48279,102,224,168,55,25,66,123,57
48281,393,476,437,17,8,44,83,39
48283,79,128,133,38,0,54,48,0
48285,149,287,230,48,20,81,138,57
48287,129,234,134,45,43,5,106,101
48289,80,177,128,55,27,48,96,48
48291,733,1970,1055,63,46,322,1237,915
48293,254,406,329,37,19,75,152,77
48295,15,24,15,38,38,,9,9
48297,94,159,140,41,12,46,65,19
48299,435,527,496,17,6,61,92,31
48301,1,7,1,83,83,,6,6
48303,10467,12979,11596,19,11,1129,2512,1383
48305,51,113,96,55,15,45,62,17
48307,76,161,178,53,0,102,85,0
48309,5221,7298,7232,28,1,2011,2077,66
48311,0,0,0,0,0,,0,0
48313,91,200,123,55,39,32,109,77
48315,237,299,287,21,4,50,62,12
48317,46,97,46,53,53,,51,51
48319,35,74,58,53,22,23,39,16
48321,637,1012,992,37,2,355,376,21
48323,913,1471,1511,38,0,598,558,0
48325,467,780,561,40,28,94,313,219
48327,32,68,32,53,53,,36,36
48329,1266,1883,1702,33,10,436,617,181
48331,301,662,461,55,30,160,361,201
48333,57,69,71,17,0,14,12,0
48335,68,119,133,43,0,65,51,0
48337,198,619,223,68,64,25,422,397
48339,5977,8285,7353,28,11,1376,2308,932
48341,164,265,198,38,25,34,101,67
48343,266,389,371,32,5,105,123,18
48345,9,19,9,55,55,,10,10
48347,1814,2845,2436,36,14,622,1031,409
48349,810,1295,1239,37,4,429,485,56
48351,88,212,117,59,45,29,125,96
48353,235,412,454,43,0,219,177,0
48355,6106,8813,9260,31,0,3154,2707,0
48357,105,169,114,38,33,9,64,55
48359,19,30,21,38,31,2,11,9
48361,959,1537,1643,38,0,684,578,0
48363,559,815,683,31,16,124,256,132
48365,163,294,238,44,19,75,131,56
48367,653,1530,996,57,35,343,877,534
48369,74,119,90,38,24,16,45,29
48371,59,349,120,83,66,61,290,229
48373,685,981,865,30,12,180,296,116
48375,4336,5318,5289,18,1,953,982,29
48377,16,92,48,83,48,32,77,45
48379,186,212,199,12,6,13,26,13
48381,2361,2758,2738,14,1,377,397,20
48383,20,43,20,53,53,,23,23
48385,51,82,51,38,38,,31,31
48387,284,415,403,32,3,119,131,12
48389,39,232,102,83,56,63,193,130
48391,47,79,84,40,0,37,32,0
48393,3,5,3,38,38,,2,2
48395,203,448,417,55,7,214,244,30
48397,854,1355,955,37,30,101,501,400
48399,111,194,151,43,22,40,83,43
48401,469,844,616,44,27,147,375,228
48403,47,113,84,59,26,37,66,29
48405,119,288,180,59,37,61,169,108
48407,197,283,206,30,27,9,85,76
48409,688,1147,1352,40,0,664,460,0
48411,90,109,117,17,0,27,19,0
48413,23,49,40,53,18,17,26,9
48415,315,551,342,43,38,27,236,209
48417,31,55,31,43,43,,24,24
48419,324,784,468,59,40,144,459,315
48421,14,22,17,38,24,3,8,5
48423,4814,6271,5649,23,10,835,1457,622
48425,116,169,141,31,17,25,53,28
48427,916,1549,1202,41,22,286,633,347
48429,140,246,235,43,4,95,105,10
48431,14,30,14,53,53,,16,16
48433,16,28,27,43,3,11,12,1
48435,32,67,32,53,53,,36,36
48437,88,141,164,38,0,76,54,0
48439,52719,63499,61651,17,3,8932,10780,1848
48441,4326,4904,5184,12,0,858,578,0
48443,3,17,3,83,83,,14,14
48445,158,349,210,55,40,52,191,139
48447,10,18,16,43,10,6,8,2
48449,623,912,760,32,17,137,289,152
48451,1255,2513,1900,50,24,645,1258,613
48453,43508,50093,49061,13,2,5553,6585,1032
48455,164,235,183,30,22,19,71,52
48457,116,281,166,59,41,50,165,115
48459,548,690,719,21,0,171,143,0
48461,15,32,15,53,53,,17,17
48463,469,756,689,38,9,220,287,67
48465,892,1438,1474,38,0,582,545,0
48467,1112,1266,1285,12,0,173,154,0
48469,1108,2272,1628,51,28,520,1164,644
48471,2262,3241,2535,30,22,273,979,706
48473,654,1039,775,37,25,121,386,265
48475,31,183,104,83,43,73,152,79
48477,510,1124,806,55,28,296,614,318
48479,7960,9357,9408,15,0,1448,1397,0
48481,908,1443,1135,37,21,227,535,308
48483,52,84,58,38,31,6,32,26
48485,2741,4485,3876,39,14,1135,1744,609
48487,137,428,235,68,45,98,292,194
48489,116,279,227,59,19,111,163,52
48491,5443,6687,6283,19,6,840,1244,404
48493,268,517,355,48,31,87,248,161
48495,15,88,32,83,64,17,73,56
48497,317,992,365,68,63,48,675,627
48499,812,925,861,12,7,49,113,64
48501,9,19,14,55,28,5,10,5
48503,178,558,301,68,46,123,380,257
48505,242,408,303,41,26,61,167,106
48507,276,444,603,38,0,327,168,0
49001,55,142,83,61,42,28,87,59
49003,223,632,368,65,42,145,409,264
49005,1960,2875,2188,32,24,228,915,687
49007,202,548,390,63,29,188,346,158
49009,7,19,7,63,63,,12,12
49011,3470,5192,4381,33,16,911,1722,811
49013,140,380,180,63,53,40,240,200
49015,63,171,105,63,38,42,108,66
49017,19,48,19,61,61,,30,30
49019,108,294,148,63,49,40,185,145
49021,535,1381,616,61,55,81,846,765
49023,35,90,35,61,61,,55,55
49025,48,125,48,61,61,,77,77
49027,59,153,59,61,61,,94,94
49029,49,71,49,32,32,,23,23
49031,7,18,7,61,61,,11,11
49033,19,28,19,32,32,,9,9
49035,24112,28794,28876,16,0,4764,4682,0
49037,48,131,49,63,62,1,83,82
49039,126,326,134,61,59,8,200,192
49041,89,230,125,61,46,36,141,105
49043,481,705,486,32,31,5,224,219
49045,378,1074,587,65,45,209,696,487
49047,191,518,232,63,55,41,327,286
49049,8051,10646,9219,24,13,1168,2595,1427
49051,196,531,197,63,63,1,335,334
49053,1883,2812,2117,33,25,234,929,695
49055,4,10,4,61,61,,6,6
49057,3877,6643,5249,42,21,1372,2766,1394
50001,412,758,593,46,22,181,346,165
50003,533,981,856,46,13,323,448,125
50005,664,973,900,32,7,236,309,73
50007,3116,4912,5288,37,0,2172,1795,0
50009,88,129,133,32,0,45,41,0
50011,629,991,1082,37,0,453,362,0
50013,63,99,108,37,0,45,36,0
50015,486,713,630,32,12,144,226,82
50017,173,389,318,55,18,145,216,71
50019,446,653,550,32,16,104,207,103
50021,997,1836,1606,46,13,609,839,230
50023,1050,1538,1808,32,0,758,488,0
50025,371,833,791,55,5,420,462,42
50027,489,1098,1040,55,5,551,609,58
51001,739,1121,836,34,25,97,382,285
51003,2544,3957,2867,36,28,323,1413,1090
51005,147,228,360,36,0,213,82,0
51007,127,233,127,46,46,,107,107
51009,586,746,616,21,17,30,160,130
51011,305,389,358,21,8,53,84,31
51013,7122,8637,8964,18,0,1842,1515,0
51015,863,1118,962,23,14,99,255,156
51017,42,54,47,23,14,5,12,7
51019,905,1153,937,21,19,32,248,216
51021,13,43,13,71,71,,31,31
51023,153,238,154,36,35,1,85,84
51025,420,772,476,46,38,56,353,297
51027,384,734,458,48,38,74,350,276
51029,185,340,230,46,32,45,155,110
51031,798,1257,891,36,29,93,459,366
51033,422,573,456,26,20,34,151,117
51035,155,535,306,71,43,151,379,228
51036,56,88,59,36,32,3,32,29
51037,205,378,206,46,45,1,173,172
51041,3910,4945,4614,21,7,704,1035,331
51043,145,158,159,8,0,14,13,0
51045,8,13,26,36,0,18,5,0
51047,966,1372,1165,30,15,199,407,208
51049,142,262,149,46,43,7,120,113
51051,277,529,486,48,8,209,252,43
51053,351,688,410,49,40,59,337,278
51057,238,361,273,34,24,35,123,88
51059,15196,20393,20450,25,0,5254,5197,0
51061,778,1106,942,30,15,164,328,164
51063,112,158,132,29,16,20,46,26
51065,185,418,228,56,46,43,233,190
51067,687,1071,830,36,22,143,384,241
51069,1121,1223,1176,8,4,55,102,47
51071,218,306,310,29,0,92,89,0
51073,436,662,527,34,20,91,226,135
51075,71,111,86,36,22,15,40,25
51077,78,269,150,71,44,72,191,119
51079,317,378,396,16,0,79,61,0
51081,170,333,188,49,44,18,163,145
51083,792,1457,903,46,38,111,665,554
51085,840,1310,1075,36,18,235,470,235
51087,7687,10076,10113,24,0,2426,2389,0
51089,772,1249,887,38,29,115,478,363
51091,8,11,8,23,23,,2,2
51093,332,664,601,50,9,269,331,62
51095,1692,1815,1798,7,1,106,124,18
51097,75,113,82,34,28,7,39,32
51099,344,467,350,26,25,6,123,117
51101,142,221,172,36,22,30,79,49
51103,237,359,313,34,13,76,122,46
51105,547,1045,871,48,17,324,498,174
51107,2279,2857,2781,20,3,502,578,76
51109,402,910,514,56,44,112,508,396
51111,216,398,216,46,46,,182,182
51113,151,214,162,30,24,11,63,52
51115,197,298,206,34,31,9,102,93
51117,685,1260,751,46,40,66,575,509
51119,154,233,182,34,22,28,80,52
51121,4920,6922,5432,29,22,512,2002,1490
51125,201,456,238,56,48,37,255,218
51127,76,118,80,36,33,4,43,39
51131,319,484,497,34,0,178,165,0
51133,194,294,217,34,26,23,100,77
51135,442,814,458,46,44,16,372,356
51137,476,677,546,30,19,70,201,131
51139,423,521,434,19,17,11,98,87
51141,200,324,238,38,26,38,124,86
51143,655,1060,751,38,29,96,405,309
51145,152,237,165,36,30,13,85,72
51147,483,889,600,46,32,117,406,289
51149,422,828,486,49,41,64,406,342
51153,5005,6513,6592,23,0,1587,1508,0
51155,972,1367,1230,29,10,258,396,138
51157,127,181,129,30,29,2,54,52
51159,124,189,129,34,31,5,64,59
51161,1073,1792,1482,40,17,409,719,310
51163,433,561,509,23,9,76,128,52
51165,1379,1659,1485,17,10,106,280,174
51167,561,1072,694,48,35,133,511,378
51169,378,722,524,48,27,146,344,198
51171,987,1217,1187,19,2,200,230,30
51173,196,675,581,71,14,385,479,94
51175,238,475,249,50,48,11,237,226
51177,1992,2708,2327,26,14,335,715,380
51179,1655,2635,1997,37,24,342,981,639
51181,63,124,73,49,41,10,61,51
51183,151,295,266,49,10,115,145,30
51185,921,1760,1152,48,35,231,839,608
51187,740,912,879,19,4,139,172,33
51191,285,981,387,71,61,102,696,594
51193,367,557,488,34,12,121,190,69
51195,1004,1919,1554,48,19,550,915,365
51197,153,527,400,71,24,247,374,127
51199,1625,1744,1756,7,0,131,119,0
51510,4689,6396,6741,27,0,2052,1707,0
51515,364,464,522,21,0,158,100,0
51520,203,698,683,71,2,480,495,15
51530,198,257,256,23,0,58,59,1
51540,2445,2913,3288,16,0,843,468,0
51550,4804,6847,6299,30,8,1495,2043,548
51570,366,717,502,49,30,136,351,215
51580,122,190,131,36,31,9,68,59
51590,1575,2549,2686,38,0,1111,974,0
51595,263,516,355,49,31,92,253,161
51600,338,354,404,5,0,66,16,0
51610,124,211,212,41,0,88,87,0
51620,413,826,651,50,21,238,412,174
51630,1299,2070,1921,37,7,622,770,148
51640,85,294,227,71,23,142,209,67
51650,5413,7421,7474,27,0,2061,2008,0
51660,2837,3412,3424,17,0,587,575,0
51670,815,1598,1407,49,12,592,783,191
51678,169,219,232,23,0,63,50,0
51680,2628,4137,3985,36,4,1357,1509,152
51683,719,1050,875,32,17,156,332,176
51685,211,309,352,32,0,141,97,0
51690,508,823,673,38,18,165,315,150
51700,4973,8161,8917,39,0,3944,3188,0
51710,9093,13545,13950,33,0,4857,4452,0
51720,173,330,357,48,0,184,157,0
51730,1392,2730,2388,49,13,996,1337,341
51735,171,184,176,7,4,5,13,8
51740,3230,5621,5377,43,4,2147,2391,244
51750,995,1400,1220,29,13,225,405,180
51760,10341,17174,16650,40,3,6309,6833,524
51770,2747,5943,4945,54,17,2198,3196,998
51775,476,1030,536,54,48,60,554,494
51790,1085,1405,1392,23,1,307,320,13
51800,1287,2571,2169,50,16,882,1284,402
51810,6179,7524,7759,18,0,1580,1345,0
51820,889,1151,1170,23,0,281,262,0
51830,680,730,747,7,0,67,50,0
51840,1029,1122,1160,8,0,131,93,0
53001,425,522,480,19,8,55,97,42
53003,723,887,893,19,0,170,165,0
53005,5001,6107,5924,18,3,923,1106,183
53007,965,1186,1269,19,0,304,221,0
53009,1450,2225,1884,35,15,434,774,340
53011,9090,11527,11509,21,0,2419,2437,18
53013,142,174,155,19,11,13,32,19
53015,2884,4028,3499,28,13,615,1144,529
53017,455,560,520,19,7,65,105,40
53019,120,230,148,48,36,28,110,82
53021,1917,2230,2294,14,0,377,313,0
53023,19,23,19,19,19,,4,4
53025,2087,2971,2492,30,16,405,884,479
53027,1441,2087,1988,31,5,547,646,99
53029,1378,2244,1617,39,28,239,866,627
53031,635,973,745,35,24,110,339,229
53033,57857,81565,78616,29,4,20759,23708,2949
53035,5100,7165,6536,29,9,1436,2065,629
53037,2077,2956,2329,30,21,252,879,627
53039,397,566,506,30,11,109,169,60
53041,1367,1950,1657,30,15,290,583,293
53043,183,225,201,19,11,18,42,24
53045,999,1446,1112,31,23,113,447,334
53047,714,1369,919,48,33,205,656,451
53049,433,604,510,28,16,77,172,95
53051,241,462,290,48,37,49,221,172
53053,20516,24429,25751,16,0,5235,3913,0
53055,345,563,353,39,37,8,217,209
53057,2189,3564,2652,39,26,463,1375,912
53059,118,169,198,30,0,80,51,0
53061,14292,20902,19240,32,8,4948,6610,1662
53063,17032,21211,20103,20,5,3071,4179,1108
53065,530,1016,660,48,35,130,487,357
53067,5661,7577,6918,25,9,1257,1916,659
53069,72,101,93,28,8,21,29,8
53071,2587,3039,3097,15,0,510,452,0
53073,5593,9045,6975,38,23,1382,3452,2070
53075,3102,3809,3272,19,14,170,707,537
53077,5875,9092,6814,35,25,939,3217,2278
54001,212,463,326,54,30,114,251,137
54003,1899,4612,2564,59,44,665,2713,2048
54005,205,582,299,65,49,94,378,284
54007,181,370,226,51,39,45,189,144
54009,487,773,658,37,15,171,286,115
54011,4010,5778,5261,31,9,1251,1768,517
54013,77,158,135,51,14,58,81,23
54015,90,181,107,51,41,17,92,75
54017,58,103,63,43,38,5,44,39
54019,410,815,635,50,22,225,405,180
54021,95,195,104,51,47,9,100,91
54023,133,290,197,54,32,64,157,93
54025,814,1507,1028,46,32,214,693,479
54027,605,1469,711,59,52,106,864,758
54029,807,1281,1043,37,19,236,474,238
54031,133,291,147,54,49,14,158,144
54033,1229,2166,1843,43,15,614,937,323
54035,306,626,591,51,6,285,320,35
54037,802,1949,1016,59,48,214,1147,933
54039,3378,6840,5522,51,19,2144,3461,1317
54041,255,557,380,54,32,125,302,177
54043,186,529,382,65,28,196,343,147
54045,470,1043,667,55,36,197,573,376
54047,337,747,470,55,37,133,410,277
54049,894,1575,1228,43,22,334,682,348
54051,741,1175,999,37,15,258,434,176
54053,379,547,645,31,0,266,167,0
54055,989,1967,1289,50,34,300,978,678
54057,511,1240,778,59,37,267,730,463
54059,267,593,630,55,0,363,325,0
54061,4173,6940,4513,40,35,340,2768,2428
54063,138,256,161,46,37,23,117,94
54065,354,861,377,59,56,23,506,483
54067,371,686,481,46,30,110,315,205
54069,1609,2552,2377,37,7,768,943,175
54071,98,215,102,54,52,4,116,112
54073,60,108,95,44,12,35,48,13
54075,110,203,112,46,45,2,93,91
54077,387,645,536,40,17,149,257,108
54079,285,812,395,65,51,110,526,416
54081,934,1858,1782,50,4,848,923,75
54083,554,1210,786,54,35,232,657,425
54085,90,185,124,51,33,34,94,60
54087,166,340,251,51,26,85,174,89
54089,211,391,317,46,19,106,180,74
54091,203,358,359,43,0,156,155,0
54093,88,191,122,54,36,34,104,70
54095,82,168,101,51,40,19,86,67
54097,255,557,481,54,14,226,302,76
54099,811,1168,1197,31,0,386,357,0
54101,187,345,269,46,22,82,159,77
54103,200,409,351,51,14,151,209,58
54105,38,68,52,44,24,14,30,16
54107,1791,3208,2717,44,15,926,1417,491
54109,187,415,323,55,22,136,228,92
55001,250,337,263,26,22,13,87,74
55003,332,540,537,39,1,205,208,3
55005,274,1135,581,76,49,307,861,554
55007,158,257,200,39,22,42,99,57
55009,8115,10861,9883,25,9,1768,2746,978
55011,149,312,178,52,43,29,163,134
55013,321,523,373,39,29,52,201,149
55015,371,736,530,50,28,159,364,205
55017,1109,1588,1538,30,3,429,479,50
55019,114,472,249,76,47,135,359,224
55021,640,1211,876,47,28,236,571,335
55023,184,386,285,52,26,101,202,101
55025,18826,23829,22394,21,6,3568,5003,1435
55027,1484,2151,1791,31,17,307,667,360
55029,201,824,347,76,58,146,623,477
55031,1187,1932,1881,39,3,694,745,51
55033,1235,1625,1448,24,11,213,391,178
55035,2963,3892,3580,24,8,617,929,312
55037,17,71,57,76,19,40,53,13
55039,1455,2883,2177,50,25,722,1429,707
55041,110,189,149,42,21,39,79,40
55043,952,1504,1155,37,23,203,553,350
55045,631,997,748,37,25,117,366,249
55047,158,321,290,51,10,132,163,31
55049,343,543,444,37,18,101,199,98
55051,104,170,154,39,9,50,65,15
55053,227,475,305,52,36,78,248,170
55055,1730,2508,2228,31,11,498,778,280
55057,433,583,525,26,10,92,150,58
55059,4623,5818,5972,21,0,1349,1195,0
55061,448,548,498,18,9,50,100,50
55063,3263,3982,4154,18,0,891,719,0
55065,225,355,270,37,24,45,131,86
55067,483,830,650,42,22,167,347,180
55069,606,1041,765,42,26,159,435,276
55071,2354,2879,2803,18,3,449,525,76
55073,3553,4197,4092,15,3,539,644,105
55075,257,1052,552,76,48,295,795,500
55077,164,333,185,51,44,21,169,148
55078,28,57,39,51,32,11,29,18
55079,53166,66302,67965,20,0,14799,13136,0
55081,554,1161,745,52,36,191,606,415
55083,143,587,259,76,56,116,444,328
55085,728,1250,910,42,27,182,522,340
55087,4338,5485,5100,21,7,762,1147,385
55089,850,1839,1095,54,40,245,990,745
55091,63,132,72,52,45,9,69,60
55093,528,1105,706,52,36,178,577,399
55095,204,847,405,76,52,201,643,442
55097,1747,2354,2107,26,10,360,607,247
55099,211,343,280,39,18,69,132,63
55101,3265,5876,4435,44,25,1170,2611,1441
55103,321,507,462,37,9,141,187,46
55105,5415,5953,6657,9,0,1242,538,0
55107,261,424,373,39,12,112,164,52
55109,1601,2108,1980,24,6,379,506,127
55111,785,1485,1130,47,24,345,700,355
55113,359,584,452,39,23,93,225,132
55115,492,998,709,51,29,217,506,289
55117,1549,3017,2166,49,28,617,1468,851
55119,286,465,365,39,22,79,179,100
55121,253,529,395,52,25,142,277,135
55123,238,498,417,52,16,179,260,81
55125,545,936,595,42,36,50,391,341
55127,3394,4282,3915,21,9,521,888,367
55129,288,469,387,39,17,99,181,82
55131,1349,2922,1833,54,37,484,1572,1088
55133,6740,8095,8251,17,0,1511,1355,0
55135,581,1178,843,51,28,262,597,335
55137,232,470,282,51,40,50,238,188
55139,2900,4885,3866,41,21,966,1985,1019
55141,1499,2020,2069,26,0,570,521,0
56001,2307,3374,2531,32,25,224,1067,843
56003,83,172,85,52,51,2,89,87
56005,432,999,598,57,40,166,567,401
56007,170,277,257,38,7,87,106,19
56009,205,334,348,38,0,143,128,0
56011,53,122,53,57,57,,69,69
56013,441,843,538,48,36,97,402,305
56015,132,306,199,57,35,67,174,107
56017,56,108,90,48,16,34,51,17
56019,98,228,122,57,46,24,129,105
56021,2234,3267,3007,32,8,773,1033,260
56023,90,186,102,52,45,12,96,84
56025,1835,2982,2397,38,20,562,1147,585
56027,38,89,54,57,39,16,50,34
56029,226,467,304,52,35,78,241,163
56031,78,181,101,57,44,23,103,80
56033,432,893,673,52,25,241,462,221
56035,65,124,65,48,48,,59,59
56037,356,681,559,48,18,203,325,122
56039,367,760,367,52,52,,393,393
56041,172,329,269,48,18,97,157,60
56043,95,219,137,57,38,42,124,82
56045,44,103,63,57,38,19,58,39
