county,Housing gap,Total ELI renters,Housing gap (asst off),Units per 100 renters,Units per 100 renters (asst off),Number of HUD asst units,AAA units,AAA units (asst off)
National,6439112,9644199,8751959,33,9,2312847,3205087,892240
1001,811,1139,944,29,17,133,327,194
1003,1855,2624,2296,29,13,441,769,328
1005,582,1502,1005,61,33,423,920,497
1007,218,470,282,54,40,64,252,188
1009,192,679,494,72,27,302,487,185
1011,207,534,396,61,26,189,327,138
1013,345,891,574,61,36,229,546,317
1015,2541,4025,3630,37,10,1089,1484,395
1017,578,1351,899,57,33,321,773,452
1019,142,377,268,62,29,126,235,109
1021,564,1318,665,57,50,101,754,653
1023,122,302,125,60,59,3,180,177
1025,280,694,341,60,51,61,413,352
1027,73,194,239,62,0,166,121,0
1029,97,257,167,62,35,70,160,90
1031,251,1015,599,75,41,348,764,416
1033,1115,1889,1798,41,5,683,774,91
1035,151,374,302,60,19,151,223,72
1037,57,134,63,57,53,6,77,71
1039,159,642,457,75,29,298,483,185
1041,191,492,386,61,22,195,301,106
1043,1499,2345,1847,36,21,348,846,498
1045,613,1277,1222,52,4,609,665,56
1047,1521,3281,2490,54,24,969,1761,792
1049,226,1227,668,82,46,442,1001,559
1051,1043,1464,1164,29,20,121,421,300
1053,685,1695,897,60,47,212,1010,798
1055,2045,3667,3063,44,16,1018,1622,604
1057,95,380,271,75,29,176,285,109
1059,179,716,533,75,26,354,537,183
1061,101,408,327,75,20,226,307,81
1063,225,486,395,54,19,170,261,91
1065,220,475,333,54,30,113,255,142
1067,168,433,315,61,27,147,265,118
1069,1385,2889,2325,52,19,940,1503,563
1071,232,1256,574,82,54,342,1024,682
1073,14405,22274,21917,35,2,7512,7869,357
1075,78,312,253,75,19,175,234,59
1077,2090,3541,3087,41,13,997,1451,454
1079,514,876,673,41,23,159,362,203
1081,5103,7672,6185,33,19,1082,2569,1487
1083,811,1723,1290,53,25,479,912,433
1085,170,420,255,60,39,85,250,165
1087,529,1365,906,61,34,377,836,459
1089,4965,9197,7359,46,20,2394,4232,1838
1091,458,989,704,54,29,246,531,285
1093,151,606,536,75,11,385,455,70
1095,1891,2957,2875,36,3,984,1066,82
1097,10248,15559,15066,34,3,4818,5311,493
1099,370,914,506,60,45,136,545,409
1101,7919,11539,10662,31,8,2743,3620,877
1103,2576,4391,3593,41,18,1017,1815,798
1105,299,646,417,54,35,118,347,229
1107,146,586,365,75,38,219,440,221
1109,885,2284,1436,61,37,551,1399,848
1111,132,350,233,62,33,101,218,117
1113,1295,3343,2079,61,38,784,2047,1263
1115,340,1199,501,72,58,161,860,699
1117,1629,2197,1908,26,13,279,568,289
1119,158,633,391,75,38,233,475,242
1121,860,2279,1792,62,21,932,1419,487
1123,614,1436,1038,57,28,424,822,398
1125,5556,9078,7763,39,14,2207,3522,1315
1127,468,1654,955,72,42,487,1185,698
1129,98,243,118,60,51,20,145,125
1131,170,419,285,60,32,115,250,135
1133,502,785,716,36,9,214,283,69
2013,10,28,10,64,64,,18,18
2016,16,45,16,64,64,,29,29
2020,5798,6909,7386,16,0,1588,1111,0
2050,77,213,123,64,42,46,136,90
2060,6,16,6,64,64,,10,10
2068,12,15,12,21,21,,3,3
2070,31,86,34,64,60,3,55,52
2090,2055,2588,2470,21,5,415,533,118
2100,54,68,54,21,21,,14,14
2110,693,873,1065,21,0,372,180,0
2122,655,824,803,21,3,148,169,21
2150,249,688,281,64,59,32,439,407
2164,20,55,20,64,64,,35,35
2170,645,812,762,21,6,117,167,50
2180,59,163,65,64,60,6,104,98
2185,60,167,62,64,63,2,107,105
2188,42,116,43,64,63,1,74,73
2220,305,384,343,21,11,38,79,41
2232,,,,0,0,,0,0
2240,46,58,46,21,21,,12,12
2261,130,163,159,21,3,29,34,5
2270,18,51,19,64,62,1,32,31
2282,6,17,6,64,64,,11,11
2290,42,117,42,64,64,,75,75
2999,405,510,541,21,0,136,105,0
4001,509,692,568,26,18,59,183,124
4003,1865,3171,2266,41,29,401,1307,906
4005,910,2694,1279,66,53,369,1784,1415
4007,443,870,484,49,44,41,428,387
4009,349,593,367,41,38,18,244,226
4011,38,65,38,41,41,,27,27
4012,240,358,240,33,33,,118,118
4013,65133,83234,76399,22,8,11266,18101,6835
4015,2920,4360,3200,33,27,280,1440,1160
4017,1281,1740,1380,26,21,99,459,360
4019,21725,26787,26120,19,2,4395,5062,667
4021,2508,4930,3139,49,36,631,2423,1792
4023,402,683,648,41,5,246,281,35
4025,3068,3802,3217,19,15,149,734,585
4027,3137,3865,4070,19,0,933,728,0
5001,563,981,791,43,19,228,418,190
5003,463,766,642,40,16,179,303,124
5005,512,878,736,42,16,224,367,143
5007,2937,3383,3478,13,0,541,446,0
5009,385,661,738,42,0,353,276,0
5011,393,651,516,40,21,123,257,134
5013,27,40,38,32,5,11,13,2
5015,434,745,543,42,27,109,311,202
5017,404,669,498,40,25,94,264,170
5019,455,768,705,41,8,250,313,63
5021,212,341,331,38,3,119,129,10
5023,258,544,333,53,39,75,286,211
5025,125,207,151,40,27,26,82,56
5027,784,1160,959,32,17,175,376,201
5029,374,449,510,17,0,136,76,0
5031,1847,2974,2934,38,1,1087,1127,40
5033,869,1203,1258,28,0,389,334,0
5035,1930,2831,2940,32,0,1010,901,0
5037,285,504,431,43,14,146,219,73
5039,295,436,356,32,18,61,141,80
5041,432,714,736,40,0,304,282,0
5043,512,847,745,40,12,233,335,102
5045,2583,3227,2925,20,9,342,644,302
5047,244,474,301,48,36,57,230,173
5049,122,257,180,53,30,58,135,77
5051,1448,2446,1928,41,21,480,998,518
5053,138,241,159,43,34,21,103,82
5055,736,1185,1045,38,12,309,449,140
5057,239,639,474,63,26,235,399,164
5059,215,364,357,41,2,142,148,6
5061,225,438,353,48,19,128,212,84
5063,421,889,615,53,31,194,468,274
5065,144,303,218,53,28,74,160,86
5067,288,540,568,47,0,280,252,0
5069,2104,3666,2833,43,23,729,1562,833
5071,492,592,618,17,0,126,100,0
5073,67,180,93,63,48,26,112,86
5075,267,430,498,38,0,231,163,0
5077,310,547,636,43,0,326,237,0
5079,257,425,332,40,22,75,168,93
5081,109,292,232,63,20,123,183,60
5083,277,537,387,48,28,110,260,150
5085,985,1230,1487,20,0,502,245,0
5087,94,161,147,42,9,53,67,14
5089,142,244,203,42,17,61,102,41
5091,464,1238,1057,63,15,593,774,181
5093,1457,2138,2161,32,0,704,681,0
5095,237,444,378,47,15,141,207,66
5097,57,97,77,41,20,20,39,19
5099,117,313,203,63,35,86,195,109
5101,67,116,93,42,19,26,48,22
5103,850,1257,1160,32,8,310,407,97
5105,106,128,115,17,10,9,21,12
5107,984,1738,1427,43,18,443,754,311
5109,72,193,104,63,46,32,121,89
5111,610,1077,1139,43,0,529,467,0
5113,186,361,295,48,18,109,175,66
5115,1180,1419,1532,17,0,352,239,0
5117,164,307,197,47,36,33,143,110
5119,10421,13776,14472,24,0,4051,3355,0
5121,227,366,376,38,0,149,139,0
5123,897,1584,1384,43,13,487,687,200
5125,1440,1799,1790,20,0,350,359,9
5127,127,247,200,48,19,73,120,47
5129,84,144,107,42,26,23,60,37
5131,2666,3691,3679,28,0,1013,1025,12
5133,289,560,357,48,36,68,272,204
5135,137,289,202,53,30,65,152,87
5137,78,165,112,53,32,34,87,53
5139,1445,2137,1832,32,14,387,692,305
5141,144,303,176,53,42,32,160,128
5143,2389,4308,3288,45,24,899,1919,1020
5145,1147,2151,1688,47,22,541,1004,463
5147,161,301,406,47,0,245,141,0
5149,309,372,419,17,0,110,63,0
6001,43936,62023,54925,29,11,10989,18087,7098
6003,19,26,20,30,26,1,8,7
6005,467,664,564,30,15,97,197,100
6007,5461,6927,6435,21,7,974,1466,492
6009,504,716,528,30,26,24,212,188
6011,232,427,268,46,37,36,195,159
6013,18743,25373,25395,26,0,6652,6630,0
6015,535,875,673,39,23,138,340,202
6017,1590,2058,2006,23,3,416,468,52
6019,25379,31789,30224,20,5,4845,6410,1565
6021,349,643,403,46,37,54,294,240
6023,2877,3998,3488,28,13,611,1121,510
6025,2480,3221,3551,23,0,1071,741,0
6027,372,528,377,30,29,5,156,151
6029,14666,18917,16753,22,11,2087,4251,2164
6031,1711,2061,2147,17,0,436,350,0
6033,1402,1789,1516,22,15,114,387,273
6035,500,818,543,39,34,43,318,275
6037,325387,399741,394449,19,1,69062,74354,5292
6039,2733,3896,3115,30,20,382,1163,781
6041,7309,9509,9822,23,0,2513,2200,0
6043,223,317,244,30,23,21,94,73
6045,1945,2482,2407,22,3,462,537,75
6047,5802,6604,6729,12,0,927,802,0
6049,140,230,207,39,10,67,89,22
6051,294,417,302,30,28,8,124,116
6053,6221,8462,8191,26,3,1970,2241,271
6055,2764,3351,3662,18,0,898,587,0
6057,1023,1681,1115,39,34,92,658,566
6059,61697,74456,77212,17,0,15515,12759,0
6061,4403,5481,5109,20,7,706,1078,372
6063,297,488,450,39,8,153,191,38
6065,29208,35864,34827,19,3,5619,6656,1037
6067,31360,40949,39945,23,2,8585,9589,1004
6069,775,1026,895,24,13,120,251,131
6071,34622,41757,40452,17,3,5830,7135,1305
6073,68240,83439,87760,18,0,19520,15199,0
6075,33881,59946,49508,43,17,15627,26065,10438
6077,12904,15724,16813,18,0,3909,2820,0
6079,7742,9394,8857,18,6,1115,1652,537
6081,16140,20143,19888,20,1,3748,4003,255
6083,10655,12895,13707,17,0,3052,2240,0
6085,45921,63152,60599,27,4,14678,17231,2553
6087,7178,9633,9875,25,0,2697,2455,0
6089,5289,6017,5882,12,2,593,728,135
6091,19,32,23,39,27,4,12,8
6093,1003,1640,1229,39,25,226,637,411
6095,7442,10472,9583,29,8,2141,3030,889
6097,11205,14991,14372,25,4,3167,3786,619
6099,9724,11314,11652,14,0,1928,1590,0
6101,1753,2466,2016,29,18,263,712,449
6103,979,1805,1193,46,34,214,826,612
6105,163,300,166,46,45,3,137,134
6107,10011,12685,10375,21,18,364,2674,2310
6109,1141,1622,1234,30,24,93,480,387
6111,12687,18291,18235,31,0,5548,5604,56
6113,6966,7625,8108,9,0,1142,659,0
6115,1568,2204,1888,29,14,320,637,317
8001,10384,13031,12684,20,3,2300,2646,346
8003,326,815,488,60,40,162,489,327
8005,14235,18185,16764,22,8,2529,3950,1421
8007,55,82,115,32,0,60,26,0
8009,21,52,46,60,12,25,31,6
8011,28,123,91,77,26,63,96,33
8013,10055,13392,12323,25,8,2268,3337,1069
8015,524,564,588,7,0,64,40,0
8017,2,7,6,77,20,4,5,1
8019,145,165,152,12,8,7,20,13
8021,58,146,129,60,11,71,88,17
8023,34,86,60,60,30,26,52,26
8025,15,66,42,77,36,27,51,24
8027,124,133,128,7,4,4,10,6
8029,361,530,487,32,8,126,169,43
8031,24353,38794,34774,37,10,10421,14441,4020
8033,18,26,22,32,17,4,8,4
8035,400,911,490,56,46,90,511,421
8037,963,1140,990,15,13,27,176,149
8039,49,218,56,77,74,7,169,162
8041,12701,15211,15856,17,0,3155,2510,0
8043,1250,1347,1381,7,0,131,97,0
8045,158,692,450,77,35,292,534,242
8047,178,202,182,12,10,4,24,20
8049,220,260,248,15,5,28,40,12
8051,421,498,449,15,10,28,77,49
8053,3,4,3,15,15,,1,1
8055,99,247,174,60,30,75,149,74
8057,3,14,4,77,70,1,11,10
8059,12301,14329,14856,14,0,2555,2028,0
8061,8,36,16,77,55,8,28,20
8063,30,135,85,77,37,55,104,49
8065,285,338,330,15,2,45,52,7
8067,986,1449,1201,32,17,215,463,248
8069,8201,10748,9862,24,8,1661,2547,886
8071,183,457,415,60,9,232,274,42
8073,33,148,68,77,54,35,115,80
8075,111,491,244,77,50,133,380,247
8077,2277,2879,3222,21,0,945,602,0
8079,10,12,10,15,15,,2,2
8081,32,141,145,77,0,113,108,0
8083,305,448,498,32,0,193,143,0
8085,523,768,767,32,0,244,246,2
8087,145,644,310,77,52,165,499,334
8089,274,686,577,60,16,303,412,109
8091,63,75,65,15,13,2,12,10
8093,239,257,242,7,6,3,18,15
8095,21,91,50,77,46,29,70,41
8097,389,461,400,15,13,11,71,60
8099,89,394,253,77,36,164,305,141
8101,4093,6233,5968,34,4,1875,2141,266
8103,14,59,38,77,37,24,46,22
8105,85,214,173,60,19,88,128,40
8107,69,303,92,77,70,23,234,211
8109,70,176,107,60,39,37,106,69
8111,26,38,27,32,29,1,12,11
8113,179,262,204,32,22,25,84,59
8115,10,45,25,77,44,15,34,19
8117,537,636,548,15,14,11,98,87
8119,320,345,337,7,2,17,25,8
8121,24,105,33,77,69,9,81,72
8123,5449,7178,6894,24,4,1445,1729,284
8125,34,149,101,77,32,67,115,48
9001,20329,32537,28895,38,11,8566,12208,3642
9003,19223,36578,32593,47,11,13370,17355,3985
9005,3366,4690,4220,28,10,854,1324,470
9007,2087,3941,3072,47,22,985,1854,869
9009,22450,36167,34245,38,5,11795,13717,1922
9011,4240,6727,6330,37,6,2090,2487,397
9013,2202,3058,2855,28,7,653,856,203
9015,1807,4146,2976,56,28,1169,2339,1170
10001,3239,4598,3925,30,15,686,1359,673
10003,9240,13768,14062,33,0,4822,4528,0
10005,1495,2738,1988,45,27,493,1243,750
11001,23848,47001,31265,49,33,7417,23153,15736
12001,12946,15458,15196,16,2,2250,2512,262
12003,267,545,454,51,17,187,277,90
12005,3809,5206,4867,27,7,1058,1397,339
12007,219,447,291,51,35,72,227,155
12009,9164,11142,11357,18,0,2193,1978,0
12011,30598,37629,38253,19,0,7655,7031,0
12013,126,327,175,62,47,49,201,152
12015,688,969,941,29,3,253,281,28
12017,528,831,570,36,31,42,303,261
12019,836,1065,1030,22,3,194,229,35
12021,3482,5088,3957,32,22,475,1606,1131
12023,943,1921,1048,51,45,105,978,873
12027,252,349,254,28,27,2,98,96
12029,74,175,94,58,46,20,101,81
12031,19187,30912,29053,38,6,9866,11725,1859
12033,6005,8526,8129,30,5,2124,2521,397
12035,422,1416,594,70,58,172,994,822
12037,221,576,254,62,56,33,354,321
12039,547,859,980,36,0,433,312,0
12041,125,295,165,58,44,40,170,130
12043,116,161,116,28,28,,45,45
12045,90,235,118,62,50,28,144,116
12047,116,275,142,58,48,26,159,133
12049,330,458,373,28,19,43,128,85
12051,482,669,541,28,19,59,187,128
12053,1150,1790,1457,36,19,307,640,333
12055,1493,2071,1658,28,20,165,579,414
12057,24646,31302,31275,21,0,6629,6656,27
12059,185,291,302,37,0,117,107,0
12061,1558,2154,1735,28,19,177,596,419
12063,580,916,907,37,1,327,336,9
12065,77,199,165,62,17,88,123,35
12067,34,80,63,58,22,29,46,17
12069,2509,4293,2999,42,30,490,1784,1294
12071,6473,9359,8263,31,12,1790,2886,1096
12073,12252,14928,13811,18,7,1559,2676,1117
12075,338,798,489,58,39,151,461,310
12077,22,56,33,62,42,11,34,23
12079,187,485,303,62,38,116,298,182
12081,4904,6824,5930,28,13,1026,1920,894
12083,2991,4279,3964,30,7,973,1288,315
12085,1045,1286,1163,19,10,118,241,123
12086,64828,92033,89468,30,3,24640,27205,2565
12087,2132,2666,2574,20,3,442,534,92
12089,301,679,410,56,40,109,378,269
12091,2422,4067,3155,40,22,733,1645,912
12093,263,364,263,28,28,,101,101
12095,22142,26300,26269,16,0,4127,4158,31
12097,4039,4553,4269,11,6,230,514,284
12099,18440,23573,23357,22,1,4917,5133,216
12101,8085,9768,9342,17,4,1257,1683,426
12103,17933,21830,23414,18,0,5481,3897,0
12105,8894,12390,10584,28,15,1690,3496,1806
12107,328,1101,744,70,32,416,773,357
12109,3259,4479,3440,27,23,181,1220,1039
12111,3063,4945,3900,38,21,837,1882,1045
12113,660,1126,927,41,18,267,466,199
12115,4875,6600,5888,26,11,1013,1725,712
12117,6334,7784,7014,19,10,680,1450,770
12119,267,420,313,36,26,46,153,107
12121,328,774,455,58,41,127,447,320
12123,147,382,205,62,46,58,235,177
12125,75,153,177,51,0,102,78,0
12127,5865,8507,7764,31,9,1899,2642,743
12129,177,459,244,62,47,67,282,215
12131,1028,1622,1265,37,22,237,594,357
12133,414,653,525,37,20,111,239,128
13001,191,450,243,57,46,52,259,207
13003,87,132,122,34,7,35,45,10
13005,187,284,344,34,0,157,96,0
13007,78,117,80,33,32,2,39,37
13009,1170,1911,1542,39,19,372,740,368
13011,213,335,241,36,28,28,122,94
13013,798,1822,1116,56,39,318,1024,706
13015,2186,2948,2603,26,12,417,762,345
13017,313,676,499,54,26,186,363,177
13019,225,486,339,54,30,114,261,147
13021,4999,8845,8086,43,9,3087,3846,759
13023,104,254,186,59,27,82,150,68
13025,59,89,87,34,3,28,30,2
13027,367,623,475,41,24,108,256,148
13029,541,673,592,20,12,51,132,81
13031,1796,4224,2112,57,50,316,2428,2112
13033,316,929,613,66,34,297,613,316
13035,263,473,326,44,31,63,210,147
13037,115,172,167,33,3,52,57,5
13039,991,1190,1249,17,0,258,199,0
13043,126,296,200,57,32,74,170,96
13045,2389,3260,3144,27,4,755,871,116
13047,854,1612,1077,47,33,223,758,535
13049,142,215,172,34,20,30,73,43
13051,8181,10755,10694,24,1,2513,2574,61
13053,277,534,284,48,47,7,258,251
13055,296,478,469,38,2,173,183,10
13057,1503,1858,1749,19,6,246,355,109
13059,7777,9426,9157,17,3,1380,1648,268
13061,81,121,99,33,18,18,40,22
13063,6245,7412,7220,16,3,975,1167,192
13065,121,184,161,34,12,40,63,23
13067,10227,13985,11559,27,17,1332,3758,2426
13069,522,790,702,34,11,180,269,89
13071,1660,2487,2090,33,16,430,827,397
13073,591,1055,649,44,38,58,464,406
13075,201,434,260,54,40,59,233,174
13077,2045,3138,2750,35,12,705,1093,388
13079,213,383,269,44,30,56,170,114
13081,1010,1950,1453,48,25,443,940,497
13083,157,297,171,47,42,14,139,125
13085,238,346,238,31,31,,108,108
13087,842,1650,1095,49,34,253,808,555
13089,20733,25954,25314,20,2,4581,5221,640
13091,137,335,366,59,0,229,198,0
13093,302,582,463,48,21,161,281,120
13095,4267,5142,5990,17,0,1723,876,0
13097,2103,2869,2440,27,15,337,766,429
13099,372,558,522,33,6,150,185,35
13101,69,117,69,41,41,,48,48
13103,785,977,859,20,12,74,192,118
13105,424,1122,635,62,43,211,699,488
13107,331,971,583,66,40,252,641,389
13109,88,206,151,57,27,63,118,55
13111,277,349,315,21,10,38,72,34
13113,1245,1910,1344,35,30,99,665,566
13115,2166,3504,2985,38,15,819,1338,519
13117,1217,1771,1289,31,27,72,554,482
13119,351,552,500,36,9,149,201,52
13121,26884,42479,36570,37,14,9686,15595,5909
13123,638,803,660,21,18,22,165,143
13125,48,141,59,66,58,11,93,82
13127,2104,2527,2774,17,0,670,423,0
13129,827,1238,1093,33,12,266,411,145
13131,543,1065,704,49,34,161,521,360
13133,292,772,373,62,52,81,481,400
13135,10452,12689,11372,18,10,920,2237,1317
13137,603,759,803,21,0,200,156,0
13139,2204,3999,2917,45,27,713,1795,1082
13141,136,361,165,62,54,29,225,196
13143,442,716,578,38,19,136,273,137
13145,283,400,303,29,24,20,117,97
13147,379,596,557,36,6,178,217,39
13149,183,259,251,29,3,68,76,8
13151,2049,2209,2251,7,0,202,160,0
13153,1755,3709,2567,53,31,812,1954,1142
13155,74,159,177,54,0,103,85,0
13157,1049,1648,1174,36,29,125,599,474
13159,238,389,305,39,22,67,151,84
13161,117,275,186,57,32,69,158,89
13163,279,819,391,66,52,112,540,428
13165,53,154,129,66,17,76,102,26
13167,168,275,217,39,21,49,106,57
13169,152,322,203,53,37,51,170,119
13171,403,725,553,44,24,150,322,172
13173,118,254,139,54,45,21,136,115
13175,984,1606,1632,39,0,648,622,0
13177,275,332,373,17,0,98,56,0
13179,2013,2506,2427,20,3,414,492,78
13181,116,307,144,62,53,28,191,163
13183,142,177,145,20,18,3,35,32
13185,3525,5983,4357,41,27,832,2458,1626
13187,601,756,620,21,18,19,155,136
13189,253,452,508,44,0,255,199,0
13191,179,223,193,20,13,14,44,30
13193,230,444,414,48,7,184,214,30
13195,655,794,711,17,10,56,139,83
13197,105,202,155,48,24,50,98,48
13199,522,738,611,29,17,89,215,126
13201,71,139,94,49,32,23,68,45
13205,744,1114,1237,33,0,493,371,0
13207,287,516,406,44,21,119,229,110
13209,96,233,120,59,49,24,138,114
13211,336,890,406,62,54,70,554,484
13213,429,643,484,33,25,55,213,158
13215,4027,6235,6257,35,0,2230,2208,0
13217,1734,2446,2209,29,10,475,712,237
13219,491,595,504,17,15,13,104,91
13221,73,192,78,62,60,5,120,115
13223,1676,2261,1871,26,17,195,585,390
13225,344,726,650,53,11,306,382,76
13227,368,535,502,31,6,134,167,33
13229,210,318,300,34,6,90,108,18
13231,210,379,218,44,42,8,168,160
13233,586,948,853,38,10,267,362,95
13235,82,200,171,59,15,89,118,29
13237,535,873,654,39,25,119,338,219
13239,51,77,52,33,32,1,26,25
13241,305,384,365,21,5,60,79,19
13243,218,326,345,33,0,127,108,0
13245,5423,9710,8962,44,8,3539,4287,748
13247,1665,2349,2012,29,14,347,684,337
13249,63,121,87,48,28,24,58,34
13251,120,353,197,66,44,77,233,156
13253,141,276,145,49,48,4,135,131
13255,2024,3105,2737,35,12,713,1081,368
13257,635,997,906,36,9,271,363,92
13259,117,176,161,33,8,44,58,14
13261,971,1874,1729,48,8,758,903,145
13263,98,138,140,29,0,42,40,0
13265,39,102,42,62,59,3,64,61
13267,213,502,346,57,31,133,288,155
13269,142,275,209,48,24,67,132,65
13271,127,311,189,59,39,62,183,121
13273,310,464,409,33,12,99,154,55
13275,1187,2326,1575,49,32,388,1139,751
13277,548,1183,958,54,19,410,636,226
13279,444,1083,636,59,41,192,639,447
13281,119,150,121,21,19,2,31,29
13283,78,191,140,59,27,62,113,51
13285,1991,2813,2723,29,3,732,822,90
13287,145,314,243,54,22,98,169,71
13289,48,102,56,53,45,8,54,46
13291,309,389,356,21,8,47,80,33
13293,628,1130,959,44,15,331,502,171
13295,1122,2118,1449,47,32,327,996,669
13297,1041,2378,1542,56,35,501,1337,836
13299,692,1048,1114,34,0,422,356,0
13301,122,324,195,62,40,73,202,129
13303,265,779,472,66,39,207,514,307
13305,385,905,586,57,35,201,520,319
13307,34,67,36,48,45,2,32,30
13309,35,86,47,59,45,12,51,39
13311,412,519,471,21,9,59,107,48
13313,1317,1971,1489,33,24,172,654,482
13315,38,94,62,59,33,24,55,31
13317,159,421,281,62,33,122,262,140
13319,99,162,156,39,4,57,63,6
13321,674,1010,796,33,21,122,336,214
15001,3998,5373,5205,26,3,1207,1375,168
15003,17344,26443,25192,34,5,7848,9099,1251
15005,2,3,2,32,32,,1,1
15007,980,1432,1541,32,0,561,452,0
15009,2788,4073,3797,32,7,1009,1285,276
16001,7122,8952,8674,20,3,1552,1830,278
16003,44,71,46,38,35,2,27,25
16005,1461,2088,1917,30,8,456,627,171
16007,48,69,74,30,0,26,21,0
16009,122,144,143,15,1,21,22,1
16011,305,436,395,30,9,90,131,41
16013,282,427,317,34,26,35,145,110
16015,81,130,104,38,20,23,49,26
16017,500,591,577,15,2,77,91,14
16019,1334,1991,1750,33,12,416,657,241
16021,127,150,142,15,5,15,23,8
16023,22,32,23,33,30,1,11,10
16025,3,5,3,34,34,,2,2
16027,2565,3801,3199,33,16,634,1236,602
16029,31,45,52,30,0,21,13,0
16031,147,222,219,34,2,72,76,4
16033,3,5,3,33,33,,2,2
16035,95,119,110,20,8,15,24,9
16037,23,34,23,33,33,,11,11
16039,362,584,423,38,28,61,222,161
16041,99,141,113,30,20,14,42,28
16043,66,99,94,33,5,28,33,5
16045,232,375,251,38,33,19,142,123
16047,113,172,133,34,22,20,58,38
16049,222,278,261,20,6,39,56,17
16051,113,169,128,33,24,15,56,41
16053,166,252,228,34,9,62,86,24
16055,2221,2625,2575,15,2,354,404,50
16057,1464,1834,1562,20,15,98,370,272
16059,88,132,116,33,12,28,43,15
16061,71,89,99,20,0,28,18,0
16063,26,40,33,34,16,7,14,7
16065,992,1481,1057,33,29,65,489,424
16067,85,128,119,34,8,34,44,10
16069,925,1159,1299,20,0,374,234,0
16071,51,73,57,30,22,6,22,16
16073,158,255,170,38,33,12,97,85
16075,304,491,375,38,24,71,186,115
16077,65,93,85,30,9,20,28,8
16079,219,258,300,15,0,81,40,0
16081,167,250,169,33,32,2,83,81
16083,695,1052,1025,34,3,330,358,28
16085,135,218,139,38,36,4,83,79
16087,167,269,207,38,23,40,102,62
17001,1339,2449,1663,45,32,324,1110,786
17003,82,405,336,80,17,254,323,69
17005,94,336,206,72,39,112,243,131
17007,479,846,717,43,15,238,368,130
17009,95,173,154,45,11,59,79,20
17011,435,1043,568,58,46,133,608,475
17013,79,138,102,43,27,23,60,37
17015,125,257,176,51,31,51,131,80
17017,185,327,227,43,30,42,141,99
17019,9169,11584,10154,21,12,985,2415,1430
17021,838,1577,1095,47,31,257,739,482
17023,208,790,287,74,64,79,582,503
17025,169,643,286,74,55,117,473,356
17027,235,470,369,50,22,134,236,102
17029,2826,3980,3194,29,20,368,1154,786
17031,185395,255518,235984,27,8,50589,70123,19534
17033,234,886,247,74,72,13,652,639
17035,116,163,162,29,1,46,47,1
17037,3160,4458,3932,29,12,772,1298,526
17039,339,637,445,47,30,106,298,192
17041,320,450,324,29,28,4,131,127
17043,11703,15172,14400,23,5,2697,3469,772
17045,346,487,467,29,4,121,141,20
17047,33,163,75,80,54,42,130,88
17049,248,892,527,72,41,279,643,364
17051,130,468,168,72,64,38,338,300
17053,102,236,164,57,31,62,134,72
17055,646,1076,1059,40,2,413,430,17
17057,649,964,979,33,0,330,315,0
17059,42,210,110,80,47,68,167,99
17061,166,292,289,43,1,123,126,3
17063,220,594,394,63,34,174,375,201
17065,63,313,72,80,77,9,250,241
17067,231,342,272,33,21,41,112,71
17069,33,164,114,80,30,81,131,50
17071,122,182,154,33,15,32,59,27
17073,632,1163,981,46,16,349,531,182
17075,391,905,398,57,56,7,514,507
17077,3196,5322,3902,40,27,706,2125,1419
17079,101,383,127,74,67,26,282,256
17081,744,1299,1147,43,12,403,555,152
17083,273,382,548,28,0,275,109,0
17085,174,356,259,51,27,85,182,97
17087,56,276,134,80,52,78,221,143
17089,5461,8671,7787,37,10,2326,3210,884
17091,2426,3096,3115,22,0,689,670,0
17093,460,849,625,46,26,165,389,224
17095,911,2182,1424,58,35,513,1271,758
17097,7847,11418,11795,31,0,3948,3571,0
17099,2250,3087,2958,27,4,708,837,129
17101,183,693,275,74,60,92,510,418
17103,521,735,697,29,5,176,214,38
17105,401,928,588,57,37,187,527,340
17107,295,596,458,51,23,163,301,138
17109,1483,2202,1791,33,19,308,719,411
17111,3064,4904,3795,38,23,731,1840,1109
17113,5524,8108,6629,32,18,1105,2584,1479
17115,3232,4625,4605,30,0,1373,1393,20
17117,633,1116,829,43,26,196,483,287
17119,5141,8067,7168,36,11,2027,2926,899
17121,797,1392,1189,43,15,392,595,203
17123,140,336,176,58,48,36,196,160
17125,183,335,241,45,28,58,152,94
17127,119,586,270,80,54,151,468,317
17129,113,229,263,51,0,150,115,0
17131,159,293,200,46,32,41,134,93
17133,210,420,211,50,50,1,211,210
17135,206,740,336,72,55,130,534,404
17137,748,1319,1120,43,15,372,571,199
17139,186,350,197,47,44,11,164,153
17141,423,1071,681,60,36,258,648,390
17143,2971,6785,5260,56,22,2289,3814,1525
17145,310,515,456,40,12,146,206,60
17147,251,471,267,47,43,16,221,205
17149,217,397,322,45,19,105,180,75
17151,39,194,95,80,51,56,155,99
17153,98,486,189,80,61,91,388,297
17155,53,128,54,58,57,1,74,73
17157,462,807,590,43,27,128,345,217
17159,188,714,312,74,56,124,526,402
17161,3179,5721,5360,44,6,2181,2542,361
17163,6354,9938,10393,36,0,4039,3584,0
17165,307,1516,659,80,57,352,1209,857
17167,4293,7180,5510,40,23,1217,2887,1670
17169,57,104,57,45,45,,47,47
17171,31,54,79,43,0,48,23,0
17173,316,595,409,47,31,93,279,186
17175,34,82,49,58,40,15,48,33
17177,626,1583,968,60,39,342,957,615
17179,1647,3427,2560,52,25,913,1780,867
17181,129,638,291,80,54,162,509,347
17183,1416,3279,2369,57,28,953,1863,910
17185,59,291,129,80,56,70,232,162
17187,381,566,503,33,11,122,185,63
17189,154,268,159,43,41,5,115,110
17191,208,790,342,74,57,134,582,448
17193,99,491,183,80,63,84,392,308
17195,659,1350,959,51,29,300,691,391
17197,5280,7750,7240,32,7,1960,2469,509
17199,1388,2311,1953,40,15,565,923,358
17201,7934,10675,10641,26,0,2707,2740,33
17203,127,337,292,62,13,165,210,45
18001,383,667,573,43,14,190,284,94
18003,7531,10331,10237,27,1,2706,2800,94
18005,577,1204,1171,52,3,594,627,33
18007,79,120,86,34,28,7,41,34
18009,148,376,246,61,35,98,228,130
18011,413,562,595,27,0,182,149,0
18013,66,138,77,52,44,11,72,61
18015,149,225,153,34,32,4,76,72
18017,286,623,520,54,16,234,337,103
18019,2058,3467,3251,41,6,1193,1409,216
18021,338,525,533,36,0,195,187,0
18023,601,720,706,16,2,105,118,13
18025,144,244,203,41,17,59,100,41
18027,323,854,634,62,26,311,531,220
18029,994,1254,1159,21,8,165,259,94
18031,395,563,501,30,11,106,168,62
18033,315,637,359,51,44,44,322,278
18035,4310,6025,5536,28,8,1226,1715,489
18037,265,614,455,57,26,190,349,159
18039,2623,5254,3756,50,29,1133,2631,1498
18041,541,771,754,30,2,213,230,17
18043,540,1856,1598,71,14,1058,1316,258
18045,156,235,187,34,21,31,80,49
18047,190,271,234,30,14,44,81,37
18049,384,525,447,27,15,63,141,78
18051,321,743,536,57,28,215,423,208
18053,903,2293,1524,61,34,621,1390,769
18055,410,845,639,51,24,229,434,205
18057,1148,1407,1506,18,0,358,259,0
18059,614,737,716,17,3,102,123,21
18061,128,440,198,71,55,70,312,242
18063,1166,1758,1300,34,26,134,591,457
18065,577,825,920,30,0,343,248,0
18067,1711,3974,2623,57,34,912,2263,1351
18069,372,647,468,43,28,96,275,179
18071,414,863,630,52,27,216,449,233
18073,491,673,535,27,20,44,181,137
18075,190,482,222,61,54,32,292,260
18077,885,1116,1126,21,0,241,231,0
18079,480,684,516,30,25,36,204,168
18081,1322,1861,1724,29,7,402,539,137
18083,691,1828,1416,62,23,725,1137,412
18085,1028,1709,1168,40,32,140,680,540
18087,254,514,279,51,46,25,260,235
18089,13142,19056,18575,31,3,5433,5914,481
18091,2199,3298,2821,33,14,622,1099,477
18093,1141,1934,1441,41,25,300,793,493
18095,3069,5575,4352,45,22,1283,2506,1223
18097,31161,40897,38924,24,5,7763,9736,1973
18099,520,863,654,40,24,134,344,210
18101,87,231,93,62,60,6,143,137
18103,379,825,529,54,36,150,446,296
18105,5835,6685,6982,13,0,1147,850,0
18107,430,649,702,34,0,272,219,0
18109,626,942,995,34,0,369,317,0
18111,156,214,167,27,22,11,58,47
18113,411,831,608,51,27,197,420,223
18115,153,192,158,21,18,5,40,35
18117,561,951,660,41,31,99,390,291
18119,167,344,224,51,35,57,177,120
18121,102,211,175,51,17,73,108,35
18123,156,360,406,57,0,250,205,0
18125,116,268,162,57,40,46,152,106
18127,3198,4013,3538,20,12,340,815,475
18129,174,314,313,45,0,139,140,1
18131,220,301,224,27,26,4,81,77
18133,394,811,566,51,30,172,417,245
18135,235,336,297,30,12,62,101,39
18137,606,764,654,21,14,48,158,110
18139,232,331,284,30,14,52,99,47
18141,4074,6590,6998,38,0,2924,2516,0
18143,409,689,550,41,20,141,280,139
18145,391,470,574,17,0,183,78,0
18147,143,332,215,57,35,72,189,117
18149,329,451,345,27,23,16,121,105
18151,414,838,571,51,32,157,424,267
18153,220,582,360,62,38,140,362,222
18155,140,177,145,21,18,5,37,32
18157,7017,8398,8362,16,0,1345,1382,37
18159,189,439,196,57,55,7,250,243
18161,104,148,134,30,10,30,44,14
18163,5594,8265,7742,32,6,2148,2671,523
18165,261,406,366,36,10,105,144,39
18167,3116,4838,4164,36,14,1048,1722,674
18169,285,621,405,54,35,120,335,215
18171,87,131,92,34,30,5,44,39
18173,387,697,488,45,30,101,311,210
18175,531,900,580,41,36,49,369,320
18177,912,1304,1596,30,0,684,392,0
18179,303,528,396,43,25,93,224,131
18181,371,561,417,34,26,46,190,144
18183,315,547,349,43,36,34,233,199
19001,60,187,97,68,48,37,127,90
19003,31,97,55,68,43,24,66,42
19005,118,427,155,72,64,37,309,272
19007,182,565,326,68,42,144,383,239
19009,33,79,48,59,40,15,47,32
19011,105,418,172,75,59,67,312,245
19013,4007,4296,5044,7,0,1037,289,0
19015,469,661,604,29,9,135,192,57
19017,176,637,259,72,59,83,461,378
19019,141,511,180,72,65,39,370,331
19021,116,412,209,72,49,93,296,203
19023,91,330,100,72,70,9,239,230
19025,104,208,137,50,34,33,105,72
19027,226,544,372,59,32,146,318,172
19029,259,458,380,43,17,121,199,78
19031,220,296,257,25,13,37,75,38
19033,749,1248,1109,40,11,360,499,139
19035,63,152,136,59,11,73,89,16
19037,69,250,110,72,56,41,181,140
19039,57,178,99,68,44,42,121,79
19041,103,365,293,72,20,190,262,72
19043,142,514,168,72,67,26,372,346
19045,1250,1677,1548,25,8,298,427,129
19047,115,278,213,59,23,98,163,65
19049,640,902,797,29,12,157,262,105
19051,48,149,89,68,40,41,101,60
19053,144,447,216,68,52,72,303,231
19055,145,194,237,25,0,92,49,0
19057,523,1251,903,58,28,380,727,347
19059,114,405,210,72,48,96,290,194
19061,1966,2637,2849,25,0,883,671,0
19063,69,245,128,72,48,59,176,117
19065,195,705,275,72,61,80,510,430
19067,235,392,377,40,4,142,157,15
19069,102,170,154,40,9,52,68,16
19071,95,169,129,43,23,34,73,39
19073,85,206,146,59,29,61,120,59
19075,42,153,48,72,68,6,111,105
19077,102,247,166,59,33,64,144,80
19079,238,478,275,50,42,37,240,203
19081,104,173,120,40,31,16,69,53
19083,98,390,129,75,67,31,292,261
19085,244,431,420,43,3,176,187,11
19087,263,629,333,58,47,70,366,296
19089,78,282,99,72,65,21,204,183
19091,151,303,174,50,43,23,152,129
19093,38,91,92,59,0,54,53,0
19095,78,307,85,75,72,7,230,223
19097,290,389,474,25,0,184,99,0
19099,788,1481,1014,47,32,226,693,467
19101,257,797,378,68,53,121,541,420
19103,7984,9376,8896,15,5,912,1392,480
19105,91,362,180,75,50,89,270,181
19107,75,233,122,68,48,47,158,111
19109,114,191,184,40,3,70,76,6
19111,444,1061,753,58,29,309,617,308
19113,4339,7405,5906,41,20,1567,3066,1499
19115,92,219,106,58,52,14,127,113
19117,98,304,168,68,45,70,206,136
19119,30,107,78,72,27,48,77,29
19121,162,305,223,47,27,61,142,81
19123,243,755,384,68,49,141,512,371
19125,519,975,677,47,31,158,456,298
19127,307,1215,481,75,60,174,909,735
19129,194,343,263,43,23,69,149,80
19131,76,126,87,40,31,11,50,39
19133,109,264,170,59,35,61,154,93
19135,95,295,172,68,42,77,200,123
19137,205,362,329,43,9,124,157,33
19139,444,1060,854,58,19,410,616,206
19141,103,364,188,72,48,85,261,176
19143,28,100,53,72,47,25,72,47
19145,256,453,405,43,11,149,197,48
19147,59,208,129,72,38,70,150,80
19149,144,347,246,59,29,102,203,101
19151,54,108,63,50,42,9,54,45
19153,11219,14235,13974,21,2,2755,3016,261
19155,1893,3347,2873,43,14,980,1455,475
19157,150,596,259,75,56,109,445,336
19159,36,111,91,68,18,55,75,20
19161,108,261,163,59,37,55,153,98
19163,5150,6507,6057,21,7,907,1357,450
19165,139,245,206,43,16,67,107,40
19167,98,348,236,72,32,138,250,112
19169,3476,4902,3855,29,21,379,1425,1046
19171,106,422,124,75,70,18,315,297
19173,36,113,63,68,44,27,76,49
19175,188,584,285,68,51,97,396,299
19177,58,181,82,68,55,24,123,99
19179,383,1191,799,68,33,416,808,392
19181,474,891,659,47,26,185,417,232
19183,157,621,227,75,63,70,464,394
19185,58,179,78,68,57,20,121,101
19187,688,1381,1221,50,12,533,694,161
19189,116,193,165,40,15,49,77,28
19191,168,608,226,72,63,58,440,382
19193,2360,3728,3634,37,3,1274,1368,94
19195,60,100,80,40,20,20,40,20
19197,169,340,233,50,31,64,171,107
20001,195,332,328,41,1,133,136,3
20003,73,124,104,41,16,31,51,20
20005,414,585,574,29,2,160,171,11
20007,46,124,59,62,52,13,77,64
20009,302,804,449,62,44,147,502,355
20011,235,398,375,41,6,140,164,24
20013,236,333,310,29,7,74,97,23
20015,525,759,826,31,0,301,234,0
20017,49,72,55,33,24,6,24,18
20019,63,107,75,41,30,12,44,32
20021,296,529,388,44,27,92,233,141
20023,22,45,38,51,15,16,23,7
20025,22,60,28,63,53,6,38,32
20027,102,168,144,39,14,42,65,23
20029,123,256,152,52,41,29,133,104
20031,130,192,156,33,19,26,63,37
20033,7,18,13,62,29,6,11,5
20035,724,1228,1002,41,18,278,504,226
20037,1053,1881,1489,44,21,436,828,392
20039,12,24,23,51,4,11,12,1
20041,239,390,330,39,16,91,152,61
20043,144,203,159,29,22,15,59,44
20045,5001,5616,5206,11,7,205,614,409
20047,25,68,34,62,49,9,42,33
20049,29,50,48,41,3,19,20,1
20051,586,1186,787,51,34,201,600,399
20053,31,64,37,52,42,6,33,27
20055,371,995,570,63,43,199,623,424
20057,413,1105,577,63,48,164,693,529
20059,484,719,637,33,11,153,234,81
20061,579,946,724,39,24,145,368,223
20063,8,15,8,51,51,,8,8
20065,21,42,32,51,24,11,21,10
20067,65,175,94,63,46,29,109,80
20069,23,62,23,63,63,,39,39
20071,6,15,9,63,43,3,10,7
20073,111,165,129,33,22,18,54,36
20075,22,59,24,63,59,2,37,35
20077,55,146,85,62,42,30,91,61
20079,383,554,765,31,0,382,171,0
20081,17,46,20,63,56,3,29,26
20083,9,25,12,63,51,3,16,13
20085,237,334,287,29,14,50,98,48
20087,219,309,240,29,22,21,90,69
20089,21,43,33,52,24,12,22,10
20091,6512,8470,8078,23,5,1566,1958,392
20093,10,27,21,63,22,11,17,6
20095,60,161,63,62,61,3,100,97
20097,16,42,28,62,34,12,26,14
20099,349,623,453,44,27,104,274,170
20101,7,18,13,63,29,6,11,5
20103,2000,2824,2445,29,13,445,824,379
20105,22,45,34,52,25,12,23,11
20107,119,202,156,41,23,37,83,46
20109,26,54,40,51,24,14,27,13
20111,1462,2170,1625,33,25,163,708,545
20113,423,489,534,14,0,111,66,0
20115,107,159,137,33,14,30,52,22
20117,75,122,102,39,17,27,47,20
20119,29,78,29,63,63,,49,49
20121,388,435,654,11,0,266,48,0
20123,75,156,99,52,37,24,81,57
20125,552,986,817,44,17,265,434,169
20127,58,95,79,39,17,21,37,16
20129,29,78,33,63,58,4,49,45
20131,121,171,166,29,3,45,50,5
20133,170,304,296,44,2,126,134,8
20135,24,65,27,63,58,3,41,38
20137,54,108,66,51,40,12,55,43
20139,273,405,333,33,18,60,132,72
20141,40,81,65,51,20,25,41,16
20143,38,79,68,52,14,30,41,11
20145,62,166,78,62,53,16,104,88
20147,35,70,63,51,11,28,36,8
20149,191,312,220,39,30,29,121,92
20151,185,492,206,62,58,21,307,286
20153,18,36,25,51,31,7,18,11
20155,1095,1266,1444,14,0,349,171,0
20157,21,43,40,52,7,19,22,3
20159,156,181,216,14,0,60,24,0
20161,2333,3815,2593,39,32,260,1482,1222
20163,28,57,47,51,17,19,29,10
20165,33,87,43,62,51,10,54,44
20167,54,109,85,51,22,31,55,24
20169,1109,2304,1533,52,33,424,1195,771
20171,10,27,12,63,55,2,17,15
20173,13505,16296,16420,17,0,2915,2791,0
20175,298,799,374,63,53,76,501,425
20177,4482,7553,6241,41,17,1759,3071,1312
20179,13,26,21,51,20,8,13,5
20181,59,119,97,51,19,38,60,22
20183,15,30,46,51,0,31,15,0
20185,24,64,40,62,37,16,40,24
20187,4,12,10,63,12,6,7,1
20189,52,140,60,63,57,8,88,80
20191,279,742,413,62,44,134,463,329
20193,113,229,162,51,29,49,116,67
20195,25,50,30,51,41,5,25,20
20197,43,63,57,33,11,14,21,7
20199,2,5,4,51,10,2,3,1
20201,37,77,78,52,0,41,40,0
20203,23,62,23,63,63,,39,39
20205,147,249,191,41,23,44,102,58
20207,49,83,50,41,40,1,34,33
20209,5385,8053,8494,33,0,3109,2668,0
21001,241,542,349,56,36,108,301,193
21003,220,369,332,40,10,112,149,37
21005,328,408,373,20,9,45,80,35
21007,72,118,105,38,10,33,45,12
21009,777,1302,1178,40,10,401,525,124
21011,135,243,219,45,10,84,108,24
21013,900,1677,1708,46,0,808,777,0
21015,1732,2459,2567,30,0,835,727,0
21017,588,1287,977,54,24,389,700,311
21019,1260,1990,2109,37,0,849,729,0
21021,737,917,1047,20,0,310,180,0
21023,81,147,152,45,0,71,65,0
21025,290,874,375,67,57,85,584,499
21027,174,346,262,50,24,88,172,84
21029,189,758,414,75,45,225,569,344
21031,123,235,246,48,0,123,113,0
21033,67,149,157,55,0,90,82,0
21035,1215,1972,1397,38,29,182,758,576
21037,2570,4310,3734,40,13,1164,1740,576
21039,45,73,64,38,12,19,28,9
21041,206,292,360,30,0,154,86,0
21043,347,547,563,37,0,216,201,0
21045,110,248,207,56,16,97,138,41
21047,944,2478,1682,62,32,738,1534,796
21049,818,1229,1461,33,0,643,411,0
21051,306,512,451,40,12,145,206,61
21053,136,305,224,56,27,88,170,82
21055,66,146,90,55,38,24,80,56
21057,67,151,129,56,14,62,84,22
21059,2466,4306,3708,43,14,1242,1840,598
21061,134,225,186,40,17,52,91,39
21063,106,167,181,37,0,75,61,0
21065,232,349,350,33,0,118,117,0
21067,9949,14927,13094,33,12,3145,4978,1833
21069,184,332,244,45,26,60,148,88
21071,507,1458,1018,65,30,511,951,440
21073,1174,2572,1778,54,31,604,1398,794
21075,188,305,382,38,0,194,117,0
21077,138,197,139,30,29,1,58,57
21079,245,368,316,33,14,71,123,52
21081,407,578,524,30,9,117,171,54
21083,689,1119,1004,38,10,315,430,115
21085,238,474,350,50,26,112,236,124
21087,170,382,305,56,20,135,212,77
21089,586,925,821,37,11,235,339,104
21091,50,110,106,55,4,56,60,4
21093,914,1969,1313,54,33,399,1055,656
21095,598,1115,963,46,14,365,516,151
21097,326,715,566,54,21,240,389,149
21099,237,396,341,40,14,104,160,56
21101,775,1707,1584,55,7,809,932,123
21103,70,281,170,75,39,100,211,111
21105,38,62,66,38,0,28,24,0
21107,519,1150,947,55,18,428,631,203
21109,249,418,362,40,13,113,168,55
21111,20706,32683,30327,37,7,9621,11977,2356
21113,1347,1676,1561,20,7,214,329,115
21115,300,862,534,65,38,234,562,328
21117,2094,4830,3800,57,21,1706,2736,1030
21119,265,798,325,67,59,60,533,473
21121,990,1844,1540,46,16,550,854,304
21123,97,193,208,50,0,111,96,0
21125,846,1417,1152,40,19,306,571,265
21127,370,584,445,37,24,75,214,139
21129,166,500,264,67,47,98,334,236
21131,244,736,260,67,65,16,491,475
21133,275,829,405,67,51,130,554,424
21135,117,211,183,45,13,66,94,28
21137,372,559,485,33,13,113,187,74
21139,12,26,14,55,47,2,14,12
21141,277,531,452,48,15,175,254,79
21143,52,137,119,62,13,67,85,18
21145,1780,2891,2800,38,3,1020,1110,90
21147,351,790,457,56,42,106,439,333
21149,153,268,246,43,8,93,114,21
21151,1932,2904,2826,33,3,894,972,78
21153,139,401,203,65,49,64,261,197
21155,167,332,356,50,0,189,165,0
21157,389,631,620,38,2,231,242,11
21159,154,443,275,65,38,121,289,168
21161,337,607,546,45,10,209,271,62
21163,162,349,208,54,40,46,187,141
21165,92,165,115,45,31,23,74,51
21167,386,480,550,20,0,164,94,0
21169,100,167,153,40,9,53,67,14
21171,181,303,278,40,8,97,122,25
21173,511,922,665,45,28,154,411,257
21175,187,338,224,45,34,37,151,114
21177,259,573,393,55,32,134,315,181
21179,408,812,715,50,12,307,404,97
21181,118,259,165,54,36,47,141,94
21183,209,461,333,55,28,124,252,128
21185,115,460,181,75,61,66,345,279
21187,173,246,198,30,19,25,73,48
21189,59,178,59,67,67,,119,119
21191,324,543,398,40,27,74,219,145
21193,479,1442,687,67,52,208,963,755
21195,785,2258,1328,65,41,543,1472,929
21197,317,476,394,33,17,77,159,82
21199,1135,2553,1551,56,39,416,1418,1002
21201,24,44,24,45,45,,19,19
21203,317,530,437,40,18,120,214,94
21205,517,932,667,45,28,150,415,265
21207,236,530,369,56,30,133,294,161
21209,647,1417,1072,54,24,425,771,346
21211,150,600,356,75,41,206,450,244
21213,241,462,307,48,34,66,221,155
21215,33,132,89,75,33,56,99,43
21217,500,1125,828,56,26,328,625,297
21219,92,241,178,62,26,86,149,63
21221,91,239,163,62,32,72,148,76
21223,26,102,28,75,73,2,77,75
21225,125,276,197,55,29,72,151,79
21227,1930,3697,2698,48,27,768,1767,999
21229,122,244,189,50,22,67,121,54
21231,353,793,524,56,34,171,440,269
21233,147,324,234,55,28,87,177,90
21235,779,1451,1391,46,4,612,672,60
21237,132,398,197,67,50,65,266,201
21239,490,609,673,20,0,183,120,0
22001,1104,2013,1979,45,2,875,909,34
22003,395,609,536,35,12,141,213,72
22005,1120,1895,1454,41,23,334,776,442
22007,148,334,161,56,52,13,186,173
22009,791,1938,1054,59,46,263,1147,884
22011,352,542,465,35,14,113,190,77
22013,243,463,337,48,27,94,220,126
22015,1068,2453,1916,56,22,848,1384,536
22017,6229,9452,9734,34,0,3505,3223,0
22019,2047,4671,3818,56,18,1771,2624,853
22021,139,228,216,39,5,77,89,12
22023,18,28,18,35,35,,10,10
22025,97,238,175,59,26,78,141,63
22027,324,617,371,48,40,47,293,246
22029,347,849,519,59,39,172,503,331
22031,361,689,606,48,12,245,327,82
22033,19317,24044,22285,20,7,2968,4726,1758
22035,438,719,691,39,4,253,280,27
22037,401,680,402,41,41,1,279,278
22039,1394,2054,1803,32,12,409,660,251
22041,561,920,703,39,24,142,359,217
22043,224,549,355,59,35,131,325,194
22045,858,1612,1481,47,8,623,753,130
22047,743,1260,884,41,30,141,517,376
22049,324,532,438,39,18,114,207,93
22051,9858,12344,11129,20,10,1271,2486,1215
22053,489,753,701,35,7,212,264,52
22055,6329,8265,8187,23,1,1858,1936,78
22057,951,2144,1436,56,33,485,1193,708
22059,93,228,137,59,40,44,135,91
22061,1718,3275,2174,48,34,456,1556,1100
22063,1196,2026,1281,41,37,85,829,744
22065,436,716,607,39,15,171,279,108
22067,781,1281,898,39,30,117,500,383
22069,1538,2930,2137,48,27,599,1393,794
22071,5805,8881,6660,35,25,855,3076,2221
22073,4349,6650,7037,35,0,2688,2301,0
22075,40,142,41,72,71,1,102,101
22077,529,897,575,41,36,46,368,322
22079,3385,4381,4338,23,1,953,996,43
22081,99,189,185,48,2,86,90,4
22083,439,721,619,39,14,180,281,101
22085,395,752,629,48,16,234,357,123
22087,92,326,97,72,70,5,234,229
22089,203,883,397,77,55,194,680,486
22091,243,411,247,41,40,4,169,165
22093,63,274,251,77,8,188,211,23
22095,218,946,447,77,53,229,729,500
22097,3330,4908,4661,32,5,1331,1578,247
22099,802,1390,1215,42,13,413,588,175
22101,1238,2146,1560,42,27,322,908,586
22103,1629,2924,1947,44,33,318,1295,977
22105,3095,4691,3480,34,26,385,1596,1211
22107,249,409,273,39,33,24,160,136
22109,1034,1414,1588,27,0,554,380,0
22111,367,602,478,39,21,111,235,124
22113,490,919,769,47,16,279,430,151
22115,1088,1676,1268,35,24,180,588,408
22117,391,873,566,55,35,175,482,307
22119,471,1080,1006,56,7,535,610,75
22121,587,665,707,12,0,120,79,0
22123,165,270,217,39,20,52,106,54
22125,172,292,203,41,30,31,120,89
22127,192,470,293,59,38,101,278,177
23001,2006,4276,3732,53,13,1726,2270,544
23003,1280,2914,2054,56,29,774,1634,860
23005,4064,7868,8321,48,0,4257,3804,0
23007,453,719,542,37,25,89,266,177
23009,540,1021,824,47,19,284,481,197
23011,3281,4185,4232,22,0,951,904,0
23013,547,1034,790,47,24,243,487,244
23015,401,611,558,34,9,157,210,53
23017,754,1197,1096,37,8,342,444,102
23019,3869,5030,5380,23,0,1511,1160,0
23021,330,428,396,23,8,66,99,33
23023,788,1202,1100,34,8,312,414,102
23025,848,1347,1021,37,24,173,499,326
23027,334,608,460,45,24,126,274,148
23029,441,1003,565,56,44,124,562,438
23031,3311,4734,4722,30,0,1411,1423,12
24001,1744,3589,2640,51,26,896,1845,949
24003,2345,5844,5103,60,13,2758,3499,741
24005,14212,19508,19520,27,0,5308,5296,0
24009,710,1140,975,38,14,265,430,165
24011,332,605,533,45,12,201,273,72
24013,1729,1929,2502,10,0,773,200,0
24015,1586,2754,2182,42,21,596,1168,572
24017,1701,2559,2487,34,3,786,858,72
24019,547,996,904,45,9,357,450,93
24021,1641,3990,2873,59,28,1232,2349,1117
24023,578,1190,719,51,40,141,612,471
24025,1428,2915,3082,51,0,1654,1487,0
24027,2725,3657,3057,25,16,332,932,600
24029,391,679,490,42,28,99,288,189
24031,12223,17594,18525,31,0,6302,5371,0
24033,17639,21993,22310,20,0,4671,4354,0
24035,364,663,495,45,25,131,299,168
24037,1431,2296,2107,38,8,676,865,189
24039,166,451,452,63,0,286,285,0
24041,612,1116,761,45,32,149,504,355
24043,3093,5163,4768,40,8,1675,2070,395
24045,831,2254,1515,63,33,684,1423,739
24047,313,850,481,63,43,168,536,368
24510,20907,41081,34656,49,16,13749,20174,6425
25001,1677,4787,2805,65,41,1128,3111,1983
25003,2613,7211,4659,64,35,2046,4598,2552
25005,13032,27206,20887,52,23,7855,14174,6319
25007,97,324,130,70,60,33,227,194
25009,19324,35829,30888,46,14,11564,16505,4941
25011,1317,2533,1964,48,22,647,1216,569
25013,15445,27537,25584,44,7,10139,12093,1954
25015,4628,6252,5654,26,10,1026,1624,598
25017,31750,51903,45955,39,11,14205,20153,5948
25019,82,274,86,70,69,4,192,188
25021,9733,18558,15294,48,18,5561,8825,3264
25023,4299,10305,8089,58,22,3790,6006,2216
25025,28884,60324,59761,52,1,30877,31441,564
25027,15429,27668,23653,44,15,8224,12238,4014
26001,73,170,93,57,46,20,98,78
26003,65,175,112,63,36,47,110,63
26005,1033,2209,1467,53,34,434,1176,742
26007,487,1142,770,57,33,283,655,372
26009,233,572,254,59,56,21,339,318
26011,323,635,386,49,39,63,312,249
26013,63,170,117,63,31,54,107,53
26015,413,883,519,53,41,106,470,364
26017,1255,2413,2401,48,1,1146,1158,12
26019,129,204,164,37,20,35,75,40
26021,3406,6308,4942,46,22,1536,2902,1366
26023,282,772,405,63,48,123,490,367
26025,2366,5143,3397,54,34,1031,2777,1746
26027,272,745,498,63,33,226,473,247
26029,304,747,402,59,46,98,442,344
26031,448,1050,562,57,46,114,602,488
26033,861,1322,1177,35,11,316,462,146
26035,437,558,592,22,0,155,122,0
26037,774,1178,983,34,17,209,404,195
26039,175,410,223,57,46,48,235,187
26041,803,1234,1127,35,9,324,431,107
26043,251,539,441,53,18,190,288,98
26045,1727,2758,2275,37,18,548,1031,483
26047,436,1072,533,59,50,97,635,538
26049,12619,17856,15968,29,11,3349,5237,1888
26051,401,788,553,49,30,152,387,235
26053,195,419,442,53,0,247,224,0
26055,1231,1945,1580,37,19,349,714,365
26057,527,674,806,22,0,279,147,0
26059,526,1270,785,59,38,259,744,485
26061,659,1415,1025,53,28,366,756,390
26063,464,768,619,40,19,155,304,149
26065,11039,16381,13960,33,15,2921,5341,2420
26067,586,1260,965,53,23,379,674,295
26069,413,812,500,49,38,87,399,312
26071,95,204,204,53,0,109,109,0
26073,2403,3074,2708,22,12,305,670,365
26075,3347,4922,4687,32,5,1340,1575,235
26077,6813,10081,9138,32,9,2325,3269,944
26079,149,366,191,59,48,42,217,175
26081,11985,17447,16542,31,5,4557,5462,905
26083,5,10,6,53,44,1,6,5
26085,136,208,232,34,0,96,71,0
26087,1125,1932,1718,42,11,593,807,214
26089,181,285,196,37,31,15,105,90
26091,1098,2653,1634,59,38,536,1555,1019
26093,882,1407,1257,37,11,375,525,150
26095,147,226,188,35,17,41,79,38
26097,176,270,200,35,26,24,94,70
26099,10263,16654,14923,38,10,4660,6391,1731
26101,300,474,405,37,15,105,174,69
26103,1056,2858,1644,63,42,588,1802,1214
26105,480,729,586,34,20,106,250,144
26107,1110,1688,1460,34,14,350,578,228
26109,233,629,518,63,18,285,397,112
26111,1266,2434,1698,48,30,432,1168,736
26113,154,379,181,59,52,27,225,198
26115,2357,3267,3444,28,0,1087,910,0
26117,561,1206,845,53,30,284,645,361
26119,108,252,155,57,39,47,145,98
26121,3754,7378,5185,49,30,1431,3624,2193
26123,583,886,699,34,21,116,304,188
26125,18545,26061,25249,29,3,6704,7516,812
26127,335,510,408,34,20,73,174,101
26129,385,755,424,49,44,39,371,332
26131,49,105,108,53,0,59,56,0
26133,313,476,460,34,3,147,163,16
26135,131,307,156,57,49,25,176,151
26137,273,641,362,57,43,89,367,278
26139,2533,3715,3130,32,16,597,1182,585
26141,90,211,174,57,18,84,121,37
26143,605,1189,676,49,43,71,584,513
26145,5981,8648,7614,31,12,1633,2667,1034
26147,3335,5727,4919,42,14,1584,2392,808
26149,406,1110,751,63,32,345,704,359
26151,655,1084,815,40,25,160,429,269
26153,81,124,181,35,0,100,43,0
26155,1459,1922,1731,24,10,272,463,191
26157,655,1084,727,40,33,72,429,357
26159,692,1383,951,50,31,259,690,431
26161,15534,20495,18680,24,9,3146,4961,1815
26163,63532,92548,84763,31,8,21231,29016,7785
26165,330,810,578,59,29,248,480,232
27001,278,468,390,41,17,112,190,78
27003,3543,5538,5196,36,6,1653,1995,342
27005,329,748,565,56,25,236,420,184
27007,454,1035,687,56,34,233,580,347
27009,724,922,1012,21,0,288,198,0
27011,117,184,145,37,21,28,68,40
27013,1825,2485,2394,27,4,569,661,92
27015,203,768,358,74,53,155,564,409
27017,551,926,723,41,22,172,375,203
27019,236,1229,550,81,55,314,993,679
27021,191,495,303,61,39,112,305,193
27023,109,412,237,74,42,128,303,175
27025,540,794,697,32,12,157,254,97
27027,1332,2645,1967,50,26,635,1313,678
27029,88,201,150,56,25,62,113,51
27031,37,97,55,61,43,18,60,42
27033,12,172,90,93,48,78,160,82
27035,1184,1991,1619,41,19,435,807,372
27037,6046,7546,8453,20,0,2407,1500,0
27039,43,148,161,71,0,118,105,0
27041,540,1325,802,59,39,262,785,523
27043,32,466,138,93,71,106,435,329
27045,72,310,171,77,45,99,238,139
27047,160,550,387,71,30,227,391,164
27049,699,1379,1119,49,19,420,680,260
27051,162,256,189,37,26,27,94,67
27053,28606,45999,43519,38,5,14913,17393,2480
27055,56,239,170,77,29,114,183,69
27057,195,444,340,56,23,145,249,104
27059,512,752,677,32,10,165,241,76
27061,436,1133,679,61,40,243,696,453
27063,16,233,69,93,71,53,217,164
27065,198,333,258,41,23,60,135,75
27067,553,1225,916,55,25,363,672,309
27069,31,62,57,50,8,26,31,5
27071,151,392,314,61,20,163,241,78
27073,37,140,80,74,43,43,103,60
27075,99,256,151,61,41,52,157,105
27077,24,55,51,56,7,27,31,4
27079,234,461,394,49,15,160,227,67
27081,33,126,65,74,48,32,93,61
27083,319,1205,584,74,52,265,886,621
27085,374,829,619,55,25,245,454,209
27087,45,104,82,56,20,37,58,21
27089,75,148,129,50,13,54,73,19
27091,41,611,193,93,68,152,569,417
27093,219,484,304,55,37,85,266,181
27095,442,743,561,41,25,119,301,182
27097,295,723,558,59,23,263,428,165
27099,266,916,620,71,32,354,650,296
27101,12,180,53,93,70,41,168,127
27103,642,874,874,27,0,232,232,0
27105,48,710,175,93,75,127,662,535
27107,82,162,155,50,5,73,81,8
27109,223,1419,1444,84,0,1221,1196,0
27111,1265,1996,1639,37,18,374,731,357
27113,192,382,336,50,12,144,189,45
27115,313,527,437,41,17,124,214,90
27117,14,206,90,93,56,76,192,116
27119,600,1191,1061,50,11,461,591,130
27121,179,283,231,37,18,52,104,52
27123,17708,24729,27444,28,0,9736,7021,0
27125,33,65,80,50,0,47,32,0
27127,118,444,194,74,56,76,326,250
27129,192,426,277,55,35,85,234,149
27131,685,1350,1122,49,17,437,665,228
27133,14,214,73,93,66,59,199,140
27135,130,257,234,50,9,104,128,24
27137,2547,5761,5576,56,3,3029,3214,185
27139,225,1175,714,81,39,489,950,461
27141,902,1326,1222,32,8,320,425,105
27143,110,243,166,55,32,56,133,77
27145,2647,3370,3566,21,0,919,723,0
27147,194,670,398,71,41,204,475,271
27149,321,507,417,37,18,96,186,90
27151,234,370,365,37,1,131,135,4
27153,166,407,315,59,23,149,241,92
27155,84,133,116,37,13,32,49,17
27157,107,461,216,77,53,109,354,245
27159,178,437,335,59,23,157,259,102
27161,276,376,395,27,0,119,100,0
27163,1844,3134,2877,41,8,1033,1290,257
27165,12,181,86,93,52,74,169,95
27167,71,112,118,37,0,47,41,0
27169,427,1830,844,77,54,417,1404,987
27171,1372,2018,1738,32,14,366,646,280
27173,82,310,145,74,53,63,228,165
28001,805,1484,1470,46,1,665,679,14
28003,440,738,863,40,0,423,298,0
28005,149,274,192,46,30,43,125,82
28007,275,600,416,54,31,141,324,183
28009,60,89,60,32,32,,29,29
28011,1629,1976,1998,18,0,369,347,0
28013,268,584,334,54,43,66,316,250
28015,157,212,170,26,20,13,56,43
28017,457,604,616,24,0,159,146,0
28019,109,237,139,54,41,30,128,98
28021,117,251,134,53,47,17,134,117
28023,243,487,364,50,25,121,244,123
28025,461,608,795,24,0,334,147,0
28027,844,1091,1386,23,0,542,247,0
28029,357,764,455,53,40,98,407,309
28031,217,465,237,53,49,20,248,228
28033,884,2408,1266,63,47,382,1524,1142
28035,1840,3090,2546,40,18,706,1250,544
28037,92,170,115,46,32,23,78,55
28039,102,219,133,53,39,31,117,86
28041,44,70,54,38,23,10,26,16
28043,702,1529,921,54,40,219,827,608
28045,384,823,406,53,51,22,439,417
28047,1240,2518,1988,51,21,748,1278,530
28049,7800,10782,10810,28,0,3010,2981,0
28051,290,462,421,37,9,131,171,40
28053,318,432,401,26,7,83,114,31
28055,38,61,50,37,17,12,23,11
28057,216,362,265,40,27,49,146,97
28059,2490,3793,3043,34,20,553,1303,750
28061,126,204,153,38,25,27,78,51
28063,133,284,273,53,4,140,151,11
28065,163,349,217,53,38,54,186,132
28067,1336,2145,1863,38,13,527,808,281
28069,145,291,226,50,22,81,146,65
28071,1184,1752,1406,32,20,222,569,347
28073,441,741,482,40,35,41,300,259
28075,1785,3576,2921,50,18,1136,1791,655
28077,108,232,153,53,34,45,124,79
28079,200,323,327,38,0,127,124,0
28081,1925,2767,2946,30,0,1021,842,0
28083,1511,2050,2136,26,0,625,539,0
28085,476,1019,736,53,28,260,543,283
28087,1385,2451,2278,43,7,893,1066,173
28089,671,1220,1084,45,11,413,550,137
28091,291,536,381,46,29,90,245,155
28093,483,715,636,32,11,153,232,79
28095,553,979,871,43,11,318,426,108
28097,199,433,323,54,25,124,234,110
28099,469,759,620,38,18,151,290,139
28101,223,448,326,50,27,103,224,121
28103,167,295,253,43,14,86,128,42
28105,2252,2973,2699,24,9,447,720,273
28107,355,459,502,23,0,147,104,0
28109,966,2069,1148,53,45,182,1103,921
28111,62,100,82,38,18,20,38,18
28113,831,1531,1320,46,14,489,700,211
28115,274,394,381,30,3,107,120,13
28117,335,562,514,40,9,179,227,48
28119,157,202,211,23,0,54,46,0
28121,1987,2672,2225,26,17,238,685,447
28123,353,572,468,38,18,115,219,104
28125,106,169,141,37,16,35,63,28
28127,240,513,283,53,45,43,273,230
28129,88,143,103,38,28,15,55,40
28131,221,474,226,53,52,5,253,248
28133,927,1258,1177,26,6,250,331,81
28135,214,291,285,26,2,71,76,5
28137,355,459,414,23,10,59,104,45
28139,304,450,429,32,5,125,146,21
28141,269,451,419,40,7,150,182,32
28143,293,379,384,23,0,91,86,0
28145,429,616,575,30,7,146,187,41
28147,104,192,144,46,25,40,88,48
28149,1251,1989,1843,37,7,592,739,147
28151,2453,2976,3023,18,0,570,523,0
28153,178,285,260,38,9,82,108,26
28155,144,314,171,54,45,27,170,143
28157,110,203,212,46,0,102,93,0
28159,277,366,374,24,0,97,89,0
28161,183,398,293,54,26,110,215,105
28163,571,908,915,37,0,344,337,0
29001,1104,1714,1287,36,25,183,610,427
29003,169,270,237,37,12,68,100,32
29005,27,107,77,75,28,50,80,30
29007,443,970,643,54,34,200,526,326
29009,778,1005,792,23,21,14,227,213
29011,80,176,123,55,30,43,96,53
29013,158,348,207,55,40,49,190,141
29015,110,242,154,55,36,44,132,88
29017,124,220,150,44,32,26,97,71
29019,5641,8233,6713,31,18,1072,2592,1520
29021,1474,2344,2114,37,10,640,871,231
29023,416,1587,878,74,45,462,1171,709
29025,72,286,174,75,39,102,214,112
29027,602,1317,841,54,36,239,715,476
29029,499,554,533,10,4,34,55,21
29031,1502,2679,2160,44,19,658,1177,519
29033,63,108,127,41,0,64,45,0
29035,42,161,47,74,71,5,119,114
29037,788,1650,1233,52,25,445,862,417
29039,125,275,183,55,33,58,150,92
29041,53,91,81,41,11,28,38,10
29043,558,805,607,31,25,49,247,198
29045,91,142,131,36,7,40,51,11
29047,2624,5055,4002,48,21,1378,2432,1054
29049,212,337,339,37,0,127,125,0
29051,1469,3212,2083,54,35,614,1744,1130
29053,272,594,364,54,39,92,322,230
29055,215,561,307,62,45,92,346,254
29057,114,147,125,23,15,11,33,22
29059,90,198,135,55,32,45,108,63
29061,34,135,73,75,46,39,101,62
29063,65,255,138,75,46,73,190,117
29065,138,360,273,62,24,135,222,87
29067,159,289,163,45,43,4,129,125
29069,843,1663,1394,49,16,551,820,269
29071,1089,2054,1370,47,33,281,965,684
29073,83,217,96,62,56,13,134,121
29075,30,117,56,75,52,26,87,61
29077,6503,8706,7980,25,8,1477,2204,727
29079,59,234,116,75,50,57,175,118
29081,45,179,116,75,35,71,134,63
29083,230,506,383,55,24,153,276,123
29085,73,160,94,55,41,21,87,66
29087,21,81,40,75,51,19,61,42
29089,124,270,194,54,28,70,147,77
29091,689,1247,1040,45,17,351,558,207
29093,204,364,235,44,35,31,160,129
29095,16865,33482,27383,50,18,10518,16618,6100
29097,2861,4098,3876,30,5,1015,1238,223
29099,1495,3464,2388,57,31,893,1969,1076
29101,881,1505,1029,41,32,148,624,476
29103,51,78,71,36,10,20,28,8
29105,634,703,805,10,0,171,69,0
29107,456,852,750,47,12,294,396,102
29109,801,1034,937,23,9,136,233,97
29111,126,195,149,36,24,23,69,46
29113,434,818,778,47,5,344,384,40
29115,281,437,398,36,9,117,155,38
29117,139,548,252,75,54,113,409,296
29119,333,430,413,23,4,80,97,17
29121,249,387,328,36,15,79,138,59
29123,168,299,200,44,33,32,131,99
29125,55,145,81,62,44,26,89,63
29127,483,1286,900,62,30,417,803,386
29129,16,64,35,75,45,19,48,29
29131,331,368,381,10,0,50,36,0
29133,388,765,635,49,17,247,377,130
29135,169,369,196,54,47,27,200,173
29137,108,288,131,62,54,23,180,157
29139,103,275,166,62,40,63,172,109
29141,214,237,265,10,0,51,23,0
29143,425,839,734,49,12,309,414,105
29145,851,1220,989,30,19,138,368,230
29147,262,1035,386,75,63,124,773,649
29149,167,301,254,45,16,87,135,48
29151,51,133,68,62,49,17,82,65
29153,92,166,108,45,35,16,74,58
29155,736,1452,1242,49,14,506,716,210
29157,180,321,243,44,24,63,141,78
29159,544,929,803,41,14,259,385,126
29161,563,1471,857,62,42,294,907,613
29163,204,544,343,62,37,139,339,200
29165,1028,2265,1325,55,41,297,1237,940
29167,251,551,267,55,52,16,301,285
29169,1029,1141,1155,10,0,126,112,0
29171,115,178,162,36,9,47,63,16
29173,80,214,99,62,54,19,134,115
29175,355,945,677,62,28,322,590,268
29177,337,630,554,47,12,217,293,76
29179,23,89,28,74,68,5,65,60
29181,95,362,134,74,63,39,267,228
29183,3389,4183,4260,19,0,871,794,0
29185,57,125,119,55,5,62,68,6
29186,168,299,219,44,27,51,131,80
29187,939,1674,1218,44,27,279,735,456
29189,20187,27258,26868,26,1,6681,7071,390
29195,314,536,506,41,6,192,222,30
29197,82,128,123,36,4,41,46,5
29199,55,85,91,36,0,36,30,0
29201,753,1485,1416,49,5,663,732,69
29203,111,201,149,45,26,38,90,52
29205,77,120,106,36,11,29,43,14
29207,287,1094,543,74,50,256,807,551
29209,488,630,510,23,19,22,142,120
29211,119,185,150,36,19,31,66,35
29213,1171,1512,1288,23,15,117,341,224
29215,354,642,545,45,15,191,287,96
29217,233,513,432,55,16,199,280,81
29219,374,704,663,47,6,289,331,42
29221,144,377,309,62,18,165,233,68
29223,126,480,162,74,66,36,354,318
29225,258,372,325,31,13,67,114,47
29227,2,10,8,75,13,6,7,1
29229,299,542,592,45,0,293,242,0
29510,16980,29483,26125,42,11,9145,12503,3358
30001,119,147,169,19,0,50,28,0
30003,68,379,87,82,77,19,312,293
30005,96,188,122,49,35,26,92,66
30007,15,21,18,29,15,3,6,3
30009,44,249,80,82,68,36,204,168
30011,3,18,6,82,66,3,15,12
30013,1757,3453,2635,49,24,878,1696,818
30015,90,176,95,49,46,5,86,81
30017,51,286,126,82,56,75,235,160
30019,6,35,10,82,71,4,28,24
30021,48,271,91,82,66,43,223,180
30023,98,138,178,29,0,80,40,0
30025,7,40,13,82,67,6,33,27
30027,88,494,134,82,73,46,406,360
30029,581,1343,809,57,40,228,762,534
30031,2021,2496,2230,19,11,209,475,266
30033,3,15,3,82,82,,12,12
30035,218,428,247,49,42,29,210,181
30037,3,16,3,82,82,,13,13
30039,23,33,23,29,29,,10,10
30041,325,639,463,49,28,138,314,176
30043,25,35,49,29,0,24,10,0
30045,13,25,20,49,21,7,12,5
30047,170,393,229,57,42,59,223,164
30049,620,873,1243,29,0,623,253,0
30051,24,47,36,49,23,12,23,11
30053,112,259,182,57,30,70,147,77
30055,6,35,7,82,79,1,29,28
30057,68,85,71,19,15,3,16,13
30059,14,17,15,19,13,1,3,2
30061,84,133,91,37,32,7,50,43
30063,3645,5813,4375,37,25,730,2167,1437
30065,25,143,56,82,60,31,117,86
30067,244,302,305,19,0,61,57,0
30069,0,2,0,82,82,,1,1
30071,12,68,40,82,41,28,56,28
30073,119,235,132,49,44,13,115,102
30075,3,16,3,82,82,,13,13
30077,33,47,46,29,1,13,14,1
30079,1,8,4,82,44,3,6,3
30081,516,823,576,37,30,60,307,247
30083,77,431,165,82,62,88,354,266
30085,58,323,92,82,72,34,266,232
30087,30,169,35,82,79,5,138,133
30089,71,165,92,57,44,21,94,73
30091,16,89,30,82,66,14,73,59
30093,466,656,828,29,0,362,190,0
30095,21,118,26,82,78,5,97,92
30097,8,47,10,82,78,2,38,36
30099,76,149,85,49,43,9,73,64
30101,58,113,77,49,32,19,56,37
30103,2,12,4,82,66,2,10,8
30105,36,203,101,82,50,65,167,102
30107,2,13,3,82,74,1,11,10
30109,3,15,3,82,82,,12,12
30111,4435,5877,5563,25,5,1128,1442,314
31001,549,911,870,40,4,321,362,41
31003,83,219,102,62,53,19,136,117
31005,0,0,0,0,0,,0,0
31007,3,10,3,67,67,,7,7
31009,0,0,0,0,0,,0,0
31011,27,71,51,62,28,24,44,20
31013,84,251,220,67,12,136,167,31
31015,8,25,17,67,31,9,17,8
31017,40,120,54,67,55,14,80,66
31019,816,1353,1167,40,14,351,538,187
31021,72,189,107,62,43,35,117,82
31023,71,189,101,63,47,30,119,89
31025,344,404,405,15,0,61,61,0
31027,65,171,86,62,50,21,106,85
31029,17,44,23,62,48,6,27,21
31031,66,197,93,67,53,27,131,104
31033,88,262,134,67,49,46,174,128
31035,68,113,86,40,24,18,45,27
31037,65,170,89,62,48,24,106,82
31039,96,252,130,62,49,34,157,123
31041,106,224,201,53,10,95,118,23
31043,327,862,571,62,34,244,535,291
31045,106,318,134,67,58,28,211,183
31047,152,399,343,62,14,191,246,55
31049,11,33,22,67,33,11,22,11
31051,54,142,66,62,54,12,88,76
31053,1386,1631,1638,15,0,252,245,0
31055,10529,16482,15418,36,6,4889,5953,1064
31057,1,3,10,62,0,9,2,0
31059,62,165,84,63,49,22,103,81
31061,10,16,25,40,0,15,7,0
31063,8,21,10,62,52,2,13,11
31065,21,55,69,62,0,48,34,0
31067,341,914,485,63,47,144,573,429
31069,7,20,12,67,41,5,13,8
31071,15,32,40,53,0,25,17,0
31073,10,25,11,62,58,1,15,14
31075,1,3,1,62,62,,2,2
31077,25,52,32,53,39,7,27,20
31079,1023,2166,1602,53,26,579,1143,564
31081,75,160,100,53,37,25,84,59
31083,23,38,34,40,11,11,15,4
31085,2,5,6,62,0,4,3,0
31087,8,21,13,62,38,5,13,8
31089,67,201,104,67,48,37,134,97
31091,1,4,1,62,62,,2,2
31093,61,130,80,53,38,19,68,49
31095,93,250,128,63,49,35,157,122
31097,64,172,76,63,56,12,108,96
31099,70,116,97,40,16,27,46,19
31101,60,158,101,62,36,41,98,57
31103,1,3,1,67,67,,2,2
31105,35,104,49,67,53,14,69,55
31107,67,175,111,62,37,44,109,65
31109,5808,10312,6795,44,34,987,4504,3517
31111,240,627,566,62,10,326,388,62
31113,2,6,2,62,62,,4,4
31115,5,11,5,53,53,,6,6
31117,0,0,0,0,0,,0,0
31119,577,1520,912,62,40,335,943,608
31121,57,121,97,53,20,40,64,24
31123,32,97,52,67,46,20,64,44
31125,23,59,45,62,25,22,37,15
31127,98,262,142,63,46,44,164,120
31129,48,79,66,40,17,18,31,13
31131,225,602,297,63,51,72,377,305
31133,18,49,49,63,0,31,31,0
31135,13,33,25,62,25,12,20,8
31137,93,154,150,40,3,57,61,4
31139,83,219,92,62,58,9,136,127
31141,356,938,493,62,47,137,582,445
31143,51,137,73,63,47,22,86,64
31145,119,312,216,62,31,97,193,96
31147,81,218,124,63,43,43,137,94
31149,7,20,13,67,36,6,13,7
31151,139,373,166,63,55,27,234,207
31153,2133,3165,2601,33,18,468,1032,564
31155,275,324,333,15,0,58,49,0
31157,484,1444,755,67,48,271,961,690
31159,240,642,291,63,55,51,403,352
31161,46,137,51,67,63,5,91,86
31163,29,62,48,53,22,19,33,14
31165,7,20,7,67,67,,14,14
31167,32,85,42,62,50,10,53,43
31169,40,107,56,63,48,16,67,51
31171,2,5,2,62,62,,3,3
31173,97,254,102,62,60,5,158,153
31175,58,122,111,53,9,53,65,12
31177,346,407,427,15,0,81,61,0
31179,133,351,157,62,55,24,218,194
31181,18,30,46,40,0,28,12,0
31183,2,5,2,53,53,,3,3
31185,162,434,294,63,32,132,272,140
32001,501,925,555,46,40,54,425,371
32003,34350,39658,40087,13,0,5737,5308,0
32005,722,925,835,22,10,113,203,90
32007,703,1299,749,46,42,46,596,550
32009,18,33,18,46,46,,15,15
32011,3,6,3,46,46,,3,3
32013,211,391,226,46,42,15,179,164
32015,105,194,125,46,36,20,89,69
32017,50,92,68,46,26,18,42,24
32019,531,680,581,22,15,50,149,99
32021,62,114,74,46,35,12,52,40
32023,673,1243,768,46,38,95,571,476
32027,38,71,44,46,37,6,33,27
32029,20,25,24,22,6,4,6,2
32031,8636,12117,10667,29,12,2031,3481,1450
32033,117,216,123,46,43,6,99,93
32510,1282,1643,1549,22,6,267,361,94
33001,668,1247,1078,46,14,410,579,169
33003,534,998,693,46,30,159,463,304
33005,826,2448,1125,66,54,299,1622,1323
33007,274,892,738,69,17,464,618,154
33009,671,2181,1018,69,53,347,1510,1163
33011,7294,10830,11651,33,0,4357,3536,0
33013,2459,4265,3500,42,18,1041,1806,765
33015,2699,4138,4165,35,0,1466,1439,0
33017,3622,5002,4922,28,2,1300,1380,80
33019,566,1679,965,66,43,399,1113,714
34001,4195,7196,7658,42,0,3463,3001,0
34003,16867,24466,23143,31,5,6276,7599,1323
34005,5272,6735,5993,22,11,721,1463,742
34007,9791,16890,15821,42,6,6030,7099,1069
34009,1618,2808,2220,42,21,602,1190,588
34011,1637,4424,4060,63,8,2423,2787,364
34013,24806,50583,45692,51,10,20886,25777,4891
34015,3763,5677,6026,34,0,2263,1913,0
34017,24736,36395,38181,32,0,13445,11659,0
34019,713,1091,1084,35,1,371,378,7
34021,8131,12810,13090,37,0,4959,4679,0
34023,14469,20960,20506,31,2,6037,6491,454
34025,8151,14480,13475,44,7,5324,6329,1005
34027,4256,7666,6369,44,17,2113,3410,1297
34029,9256,11908,12064,22,0,2808,2652,0
34031,22474,27690,28552,19,0,6078,5216,0
34033,1784,2384,2702,25,0,918,601,0
34035,4307,4984,5402,14,0,1095,677,0
34037,1385,1726,2051,20,0,666,341,0
34039,12305,16918,17634,27,0,5329,4613,0
34041,2019,3014,3284,33,0,1265,995,0
35001,17057,21933,22105,22,0,5048,4876,0
35003,20,33,27,38,16,7,12,5
35005,881,1435,1214,39,15,333,554,221
35006,173,647,275,73,58,102,475,373
35007,165,406,252,59,38,87,241,154
35009,552,1357,970,59,29,418,805,387
35011,19,46,34,59,27,15,28,13
35013,5618,7593,6440,26,15,822,1975,1153
35015,499,969,743,49,23,244,471,227
35017,493,793,730,38,8,237,300,63
35019,29,42,93,31,0,64,13,0
35021,1,2,1,59,59,,1,1
35023,79,128,129,38,0,50,48,0
35025,650,1264,985,49,22,335,613,278
35027,142,350,161,59,54,19,207,188
35028,169,207,227,19,0,58,39,0
35029,534,859,733,38,15,199,325,126
35031,390,1464,601,73,59,211,1073,862
35033,27,39,33,31,16,6,12,6
35035,910,1482,1024,39,31,114,572,458
35037,60,148,212,59,0,152,88,0
35039,248,361,362,31,0,114,113,0
35041,359,882,439,59,50,80,523,443
35043,667,1879,772,65,59,105,1212,1107
35045,1687,2600,2001,35,23,314,913,599
35047,437,637,597,31,6,160,200,40
35049,2439,2999,3456,19,0,1017,559,0
35051,257,414,373,38,10,116,156,40
35053,353,567,440,38,22,87,214,127
35055,399,581,696,31,0,297,182,0
35057,190,305,231,38,24,41,115,74
35059,33,82,68,59,16,35,48,13
35061,383,1079,596,65,45,213,696,483
36001,8575,11141,11899,23,0,3324,2566,0
36003,641,1196,714,46,40,73,555,482
36005,92125,143673,156365,36,0,64240,51548,0
36007,3680,5335,4684,31,12,1004,1655,651
36009,1145,2136,1355,46,37,210,991,781
36011,1480,2174,2010,32,8,530,694,164
36013,4074,5253,5107,22,3,1033,1179,146
36015,1655,2339,2468,29,0,813,683,0
36017,498,789,751,37,5,253,292,39
36019,1954,2766,2492,29,10,538,812,274
36021,985,1101,1339,10,0,354,115,0
36023,877,1391,1123,37,19,246,513,267
36025,637,880,816,28,7,179,243,64
36027,4229,6778,6071,38,10,1842,2549,707
36029,30291,41969,39201,28,7,8910,11678,2768
36031,753,1066,889,29,17,136,313,177
36033,1267,1794,1575,29,12,308,526,218
36035,1166,1910,1444,39,24,278,744,466
36037,1040,1999,1515,48,24,475,960,485
36039,680,759,808,10,0,128,80,0
36041,50,71,68,29,4,18,21,3
36043,1090,1840,1615,41,12,525,750,225
36045,1998,4318,3037,54,30,1039,2320,1281
36047,128108,205104,195857,38,5,67749,76996,9247
36049,325,703,428,54,39,103,378,275
36051,1324,2032,1655,35,19,331,708,377
36053,554,1239,1078,55,13,524,685,161
36055,22823,33115,29448,31,11,6625,10292,3667
36057,943,1545,1544,39,0,601,602,1
36059,12900,20286,19080,36,6,6180,7386,1206
36061,76309,135302,126222,44,7,49913,58993,9080
36063,2868,7080,5118,59,28,2250,4212,1962
36065,5997,9457,7938,37,16,1941,3460,1519
36067,13218,18822,17303,30,8,4085,5604,1519
36069,2252,3250,2843,31,13,591,998,407
36071,7338,8696,10142,16,0,2804,1358,0
36073,607,1168,865,48,26,258,560,302
36075,2653,4763,3361,44,29,708,2110,1402
36077,1292,1784,1423,28,20,131,492,361
36079,1069,1395,1295,23,7,226,327,101
36081,74640,92797,93957,20,0,19317,18157,0
36083,2981,4935,4758,40,4,1777,1954,177
36085,6014,14327,11379,58,21,5365,8313,2948
36087,5969,7499,9364,20,0,3395,1530,0
36089,2451,3567,3204,31,10,753,1116,363
36091,2031,3575,3136,43,12,1105,1544,439
36093,3346,4476,5372,25,0,2026,1130,0
36095,491,677,665,28,2,174,187,13
36097,211,297,254,29,15,43,87,44
36099,432,612,535,29,13,103,180,77
36101,1042,2250,1636,54,27,594,1208,614
36103,19404,26231,25496,26,3,6092,6827,735
36105,907,1705,1432,47,16,525,798,273
36107,464,656,595,29,9,131,192,61
36109,3455,4891,4077,29,17,622,1436,814
36111,4244,5756,5223,26,9,979,1512,533
36113,1441,1931,1779,25,8,338,490,152
36115,1110,1487,1274,25,14,164,377,213
36117,2387,2980,2870,20,4,483,593,110
36119,17937,27502,30244,35,0,12307,9564,0
36121,716,1099,817,35,26,101,383,282
36123,191,413,239,54,42,48,222,174
37001,4599,6439,6343,29,1,1744,1840,96
37003,342,634,414,46,35,72,292,220
37005,212,377,316,44,16,104,165,61
37007,317,477,518,34,0,201,160,0
37009,466,698,634,33,9,168,231,63
37011,460,687,559,33,19,99,228,129
37013,722,1150,1163,37,0,441,429,0
37015,422,672,476,37,29,54,251,197
37017,804,1439,1034,44,28,230,635,405
37019,1130,2011,1397,44,31,267,881,614
37021,3147,5219,4865,40,7,1718,2072,354
37023,1309,2426,1774,46,27,465,1117,652
37025,1028,2340,1581,56,32,553,1312,759
37027,1083,2008,1532,46,24,449,925,476
37029,86,157,98,46,38,12,72,60
37031,1177,1671,1554,30,7,377,494,117
37033,397,635,596,38,6,199,238,39
37035,1934,3143,2681,38,15,747,1209,462
37037,1173,1405,1448,17,0,275,232,0
37039,201,286,330,30,0,129,85,0
37041,128,235,343,46,0,215,107,0
37043,105,150,140,30,7,35,45,10
37045,1860,2725,2605,32,4,745,865,120
37047,1376,2465,1789,44,27,413,1089,676
37049,2576,3657,3418,30,7,842,1081,239
37051,7076,9178,9033,23,2,1957,2102,145
37053,200,367,278,46,24,78,167,89
37055,592,1087,627,46,42,35,495,460
37057,2070,2662,2899,22,0,829,592,0
37059,198,500,340,60,32,142,302,160
37061,523,1170,775,55,34,252,647,395
37063,10554,14646,12951,28,12,2397,4092,1695
37065,2072,3141,2855,34,9,783,1069,286
37067,8716,14014,11959,38,15,3243,5298,2055
37069,793,1703,1072,53,37,279,909,630
37071,3681,7423,5497,50,26,1816,3742,1926
37073,56,102,94,46,8,38,47,9
37075,130,185,214,30,0,84,55,0
37077,908,1529,1194,41,22,286,622,336
37079,206,313,291,34,7,85,107,22
37081,12254,19100,17338,36,9,5084,6846,1762
37083,1738,2973,2489,42,16,751,1235,484
37085,2670,3408,3031,22,11,361,738,377
37087,1004,1430,1329,30,7,325,426,101
37089,536,2466,974,78,61,438,1931,1493
37091,698,1194,861,42,28,163,496,333
37093,603,1317,759,54,42,156,713,557
37095,28,52,70,46,0,42,24,0
37097,3033,4733,3831,36,19,798,1700,902
37099,928,1322,1104,30,16,176,394,218
37101,2548,5467,3809,53,30,1261,2920,1659
37103,158,224,186,30,17,28,66,38
37105,1112,1419,1506,22,0,394,307,0
37107,1475,2243,2414,34,0,939,769,0
37109,1072,2162,1455,50,33,383,1090,707
37111,456,668,590,32,12,134,212,78
37113,417,594,497,30,16,80,177,97
37115,235,348,493,32,0,258,113,0
37117,533,849,841,37,1,308,316,8
37119,21695,28760,26005,25,10,4310,7065,2755
37121,263,394,413,33,0,150,130,0
37123,222,335,394,34,0,172,112,0
37125,1035,2260,1353,54,40,318,1225,907
37127,2397,3633,3094,34,15,697,1236,539
37129,4111,7317,5705,44,22,1594,3206,1612
37131,416,711,645,42,9,229,296,67
37133,1953,3557,2489,45,30,536,1604,1068
37135,6104,7310,6702,17,8,598,1206,608
37137,152,242,179,37,26,27,90,63
37139,594,1092,1044,46,4,450,497,47
37141,803,1438,884,44,39,81,635,554
37143,175,322,298,46,7,123,147,24
37145,715,1144,977,38,15,262,429,167
37147,6422,8713,7957,26,9,1535,2291,756
37149,313,459,374,32,18,61,146,85
37151,2956,3768,3919,22,0,963,812,0
37153,669,1460,1219,54,17,550,791,241
37155,2347,5278,3769,56,29,1422,2931,1509
37157,1936,3099,2329,38,25,393,1163,770
37159,3248,5286,4384,39,17,1136,2038,902
37161,1049,1537,1376,32,10,327,488,161
37163,1002,2244,1369,55,39,367,1242,875
37165,748,1632,1507,54,8,759,884,125
37167,473,713,731,34,0,258,239,0
37169,245,619,444,60,28,199,374,175
37171,1177,2097,1553,44,26,376,920,544
37173,203,289,278,30,4,75,86,11
37175,183,845,331,78,61,148,661,513
37177,28,51,59,46,0,31,23,0
37179,2288,3258,2750,30,16,462,970,508
37181,1153,1943,1501,41,23,348,790,442
37183,18826,26982,22579,30,16,3753,8156,4403
37185,299,504,401,41,20,102,205,103
37187,186,342,478,46,0,292,156,0
37189,2716,4061,2873,33,29,157,1345,1188
37191,2149,3955,3473,46,12,1324,1806,482
37193,1103,1965,1523,44,22,420,862,442
37195,1729,2630,2624,34,0,895,901,6
37197,250,631,510,60,19,260,381,121
37199,208,311,341,33,0,133,103,0
38001,18,80,31,77,61,13,62,49
38003,125,497,271,75,45,146,372,226
38005,87,345,98,75,72,11,258,247
38007,0,2,0,77,77,,2,2
38009,62,206,132,70,36,70,144,74
38011,10,45,25,77,44,15,35,20
38013,4,14,4,70,70,,10,10
38015,967,3199,1854,70,42,887,2232,1345
38017,5155,7865,6679,34,15,1524,2710,1186
38019,17,68,35,75,48,18,51,33
38021,47,188,99,75,47,52,141,89
38023,5,24,6,77,73,1,19,18
38025,7,30,11,77,64,4,24,20
38027,12,49,43,75,12,31,37,6
38029,13,43,28,70,35,15,30,15
38031,23,91,50,75,45,27,68,41
38033,10,46,16,77,64,6,36,30
38035,1921,2524,2727,24,0,806,603,0
38037,5,23,18,77,21,13,18,5
38039,18,71,39,75,45,21,53,32
38041,5,23,7,77,69,2,18,16
38043,19,62,34,70,46,15,44,29
38045,15,61,32,75,47,17,45,28
38047,7,25,13,70,45,6,17,11
38049,35,117,59,70,49,24,82,58
38051,15,48,47,70,3,32,34,2
38053,55,243,80,77,67,25,188,163
38055,43,144,66,70,54,23,100,77
38057,20,89,63,77,29,43,69,26
38059,157,691,510,77,26,353,534,181
38061,61,201,109,70,46,48,140,92
38063,19,24,40,24,0,21,6,0
38065,1,4,14,77,0,13,3,0
38067,72,94,161,24,0,89,23,0
38069,48,158,80,70,50,32,110,78
38071,131,521,353,75,32,222,389,167
38073,61,242,124,75,49,63,181,118
38075,12,41,16,70,60,4,28,24
38077,171,679,323,75,52,152,508,356
38079,149,491,198,70,60,49,343,294
38081,22,86,44,75,49,22,65,43
38083,10,34,11,70,67,1,24,23
38085,26,114,36,77,69,10,88,78
38087,5,22,5,77,77,,17,17
38089,252,1110,441,77,60,189,858,669
38091,6,8,6,24,24,,2,2
38093,251,995,556,75,44,305,744,439
38095,13,51,29,75,44,16,38,22
38097,87,114,144,24,0,57,27,0
38099,93,122,196,24,0,103,29,0
38101,702,2322,1265,70,46,563,1621,1058
38103,32,128,70,75,45,38,96,58
38105,130,575,264,77,54,134,445,311
39001,536,1038,806,48,22,270,503,233
39003,2071,3056,3172,32,0,1101,985,0
39005,793,1381,976,43,29,183,588,405
39007,3053,3872,3939,21,0,886,819,0
39009,3320,4367,3995,24,9,675,1047,372
39011,491,724,634,32,12,143,233,90
39013,1132,2553,1875,56,27,743,1421,678
39015,623,1286,852,52,34,229,662,433
39017,6330,10675,8481,41,21,2151,4345,2194
39019,380,573,499,34,13,119,193,74
39021,795,1030,978,23,5,183,235,52
39023,3240,5408,4902,40,9,1662,2168,506
39025,2831,4653,4216,39,9,1385,1823,438
39027,1422,1848,1869,23,0,447,426,0
39029,2239,4119,3029,46,26,790,1880,1090
39031,636,963,953,34,1,317,327,10
39033,412,635,765,35,0,353,223,0
39035,39239,60788,57187,35,6,17948,21549,3601
39037,628,854,824,26,3,196,225,29
39039,853,1165,1012,27,13,159,312,153
39041,805,1980,1148,59,42,343,1175,832
39043,1224,2462,1803,50,27,579,1237,658
39045,1632,2759,2479,41,10,847,1127,280
39047,1100,1430,1395,23,2,295,330,35
39049,47193,58629,59782,20,0,12589,11436,0
39051,377,441,402,14,9,25,63,38
39053,342,741,512,54,31,170,399,229
39055,433,931,655,53,30,222,498,276
39057,3404,4843,4480,30,7,1076,1439,363
39059,1014,1763,1431,43,19,417,750,333
39061,25579,42774,38113,40,11,12534,17195,4661
39063,1656,2245,2038,26,9,382,589,207
39065,957,1240,1054,23,15,97,283,186
39067,274,477,401,43,16,127,203,76
39069,434,593,471,27,21,37,159,122
39071,1180,1534,1420,23,7,240,354,114
39073,536,705,832,24,0,296,169,0
39075,340,515,380,34,26,40,175,135
39077,896,1561,1129,43,28,233,665,432
39079,341,738,589,54,20,248,397,149
39081,1505,3396,2505,56,26,1000,1891,891
39083,1035,1568,1363,34,13,328,533,205
39085,3193,3586,4250,11,0,1057,393,0
39087,583,1263,962,54,24,379,679,300
39089,1532,3941,2695,61,32,1163,2409,1246
39091,1259,1631,1572,23,4,313,372,59
39093,6014,9198,9487,35,0,3473,3184,0
39095,14721,23224,20960,37,10,6239,8503,2264
39097,1043,1390,1238,25,11,195,347,152
39099,6619,11211,9138,41,18,2519,4591,2072
39101,740,1141,1096,35,4,356,400,44
39103,1857,2200,2415,16,0,558,343,0
39105,423,556,528,24,5,105,133,28
39107,118,324,173,64,47,55,207,152
39109,2351,3105,3270,24,0,919,754,0
39111,199,306,232,35,24,33,106,73
39113,16349,23617,22249,31,6,5900,7268,1368
39115,283,434,379,35,13,96,151,55
39117,188,290,293,35,0,105,102,0
39119,2042,3121,2922,35,6,880,1079,199
39121,161,247,199,35,19,38,86,48
39123,452,909,557,50,39,105,457,352
39125,47,129,58,64,55,11,82,71
39127,703,1074,894,35,17,191,371,180
39129,1052,1402,1505,25,0,453,350,0
39131,775,1224,1126,37,8,351,449,98
39133,3739,5532,4268,32,23,529,1793,1264
39135,469,638,566,26,11,97,168,71
39137,60,166,106,64,36,46,106,60
39139,1009,2729,1890,63,31,881,1720,839
39141,1341,2119,1725,37,19,384,778,394
39143,742,1492,1014,50,32,272,750,478
39145,2023,3923,3032,48,23,1009,1900,891
39147,807,1094,966,26,12,159,287,128
39149,834,1133,1070,26,6,236,299,63
39151,8244,14097,11356,42,19,3112,5853,2741
39153,11370,20104,19030,43,5,7660,8734,1074
39155,2847,6232,4474,54,28,1627,3386,1759
39157,1663,2893,2142,43,26,479,1230,751
39159,723,963,951,25,1,228,241,13
39161,73,201,105,64,48,32,128,96
39163,309,406,421,24,0,112,97,0
39165,1181,1934,1988,39,0,807,753,0
39167,1700,2608,2134,35,18,434,908,474
39169,1105,2653,1812,58,32,707,1548,841
39171,913,1248,986,27,21,73,335,262
39173,2172,2793,2760,22,1,588,621,33
39175,303,410,332,26,19,29,108,79
40001,223,411,273,46,34,50,188,138
40003,4,35,5,89,86,1,31,30
40005,191,295,266,35,10,75,104,29
40007,3,28,4,89,85,1,25,24
40009,284,443,454,36,0,170,159,0
40011,11,101,49,89,51,38,90,52
40013,1013,1564,1142,35,27,129,552,423
40015,328,548,452,40,18,124,220,96
40017,696,1463,911,52,38,215,767,552
40019,1019,1574,1219,35,23,200,555,355
40021,721,1328,876,46,34,155,607,452
40023,344,567,595,39,0,251,223,0
40025,2,16,3,89,83,1,14,13
40027,6796,7898,7678,14,3,882,1103,221
40029,101,155,152,35,2,51,55,4
40031,2263,3784,3035,40,20,772,1521,749
40033,58,97,77,40,21,19,39,20
40035,112,190,185,41,3,73,78,5
40037,603,1352,1028,55,24,425,749,324
40039,623,973,670,36,31,47,350,303
40041,317,539,336,41,38,19,222,203
40043,5,45,9,89,80,4,40,36
40045,2,17,4,89,77,2,15,13
40047,634,899,846,29,6,212,264,52
40049,366,565,473,35,16,107,199,92
40051,291,755,435,61,42,144,464,320
40053,4,33,7,89,80,3,29,26
40055,66,103,109,36,0,43,37,0
40057,44,68,62,36,9,18,24,6
40059,2,18,2,89,89,,16,16
40061,188,310,237,39,23,49,122,73
40063,99,222,168,55,24,69,123,54
40065,587,916,714,36,22,127,329,202
40067,37,62,116,40,0,79,25,0
40069,182,282,217,35,23,35,99,64
40071,504,714,767,29,0,263,210,0
40073,14,128,36,89,72,22,114,92
40075,122,190,217,36,0,95,68,0
40077,174,287,223,39,22,49,113,64
40079,895,1474,997,39,32,102,579,477
40081,220,496,283,56,43,63,276,213
40083,266,599,436,56,27,170,333,163
40085,69,106,96,35,10,27,37,10
40087,157,406,183,61,55,26,250,224
40089,846,1393,1185,39,15,339,547,208
40091,292,537,317,46,41,25,245,220
40093,6,54,38,89,29,32,48,16
40095,218,337,254,35,25,36,119,83
40097,420,714,552,41,23,132,294,162
40099,249,385,258,35,33,9,136,127
40101,1338,2464,1937,46,21,599,1126,527
40103,136,193,141,29,27,5,57,52
40105,118,200,163,41,19,45,82,37
40107,138,310,184,55,41,46,171,125
40109,19976,25403,28054,21,0,8078,5427,0
40111,690,1270,992,46,22,302,580,278
40113,355,659,724,46,0,369,305,0
40115,411,699,593,41,15,182,288,106
40117,154,345,184,55,47,30,191,161
40119,1909,4279,2348,55,45,439,2371,1932
40121,1027,1691,1314,39,22,287,664,377
40123,1154,1782,1329,35,25,175,628,453
40125,856,1929,1344,56,30,488,1073,585
40127,147,242,235,39,3,88,95,7
40129,25,39,36,36,7,11,14,3
40131,1167,1536,1428,24,7,261,369,108
40133,318,714,516,55,28,198,395,197
40135,572,1054,768,46,27,196,482,286
40137,535,894,641,40,28,106,359,253
40139,23,213,34,89,84,11,189,178
40141,117,196,137,40,30,20,79,59
40143,16669,23627,21891,29,7,5222,6958,1736
40145,1112,1464,1351,24,8,239,352,113
40147,662,1126,957,41,15,295,464,169
40149,99,154,103,36,33,4,55,51
40151,19,177,53,89,70,34,157,123
40153,27,243,82,89,66,55,216,161
41001,290,604,409,52,32,119,314,195
41003,2610,3703,3145,30,15,535,1093,558
41005,6521,9792,7957,33,19,1436,3271,1835
41007,969,1327,1175,27,11,206,358,152
41009,515,706,773,27,0,258,191,0
41011,1616,2014,2027,20,0,411,398,0
41013,249,295,317,16,0,68,46,0
41015,576,718,631,20,12,55,142,87
41017,1926,2751,2544,30,8,618,825,207
41019,1825,2744,2295,33,16,470,919,449
41021,24,29,26,16,9,2,5,3
41023,81,96,127,16,0,46,15,0
41025,66,117,117,43,0,51,51,0
41027,329,389,381,16,2,52,61,9
41029,2851,4822,3927,41,19,1076,1971,895
41031,268,317,311,16,2,43,49,6
41033,2188,2727,2602,20,5,414,539,125
41035,829,1464,1160,43,21,331,635,304
41037,60,106,81,43,23,21,46,25
41039,12655,15131,14744,16,3,2089,2476,387
41041,1084,1485,1449,27,2,365,401,36
41043,1911,2712,2491,30,8,580,801,221
41045,257,454,486,43,0,229,197,0
41047,6616,8773,8904,25,0,2288,2157,0
41049,114,135,126,16,7,12,21,9
41051,28625,37128,31916,23,14,3291,8503,5212
41053,1382,2194,2013,37,8,631,812,181
41055,26,31,34,16,0,8,5,0
41057,490,672,559,27,17,69,181,112
41059,1001,2084,1359,52,35,358,1082,724
41061,385,801,626,52,22,241,416,175
41063,72,150,107,52,29,35,78,43
41065,362,428,531,16,0,169,67,0
41067,11130,13697,13086,19,4,1956,2568,612
41069,11,13,12,16,8,1,2,1
41071,1709,2714,2267,37,16,558,1005,447
42001,903,1445,1215,38,16,312,542,230
42003,29282,47000,46163,38,2,16881,17718,837
42005,651,1184,1148,45,3,497,533,36
42007,2052,4527,4168,55,8,2116,2475,359
42009,958,1455,1198,34,18,240,497,257
42011,7244,9735,9954,26,0,2710,2491,0
42013,1169,3149,2622,63,17,1453,1980,527
42015,981,1764,1379,44,22,398,782,384
42017,8462,11454,11312,26,1,2850,2992,142
42019,2724,3727,4040,27,0,1316,1003,0
42021,1013,4104,2359,75,43,1346,3091,1745
42023,104,171,134,39,22,30,67,37
42025,1183,2000,1719,41,14,536,817,281
42027,7083,7848,7698,10,2,615,765,150
42029,5450,8478,6995,36,17,1545,3028,1483
42031,457,909,715,50,21,258,452,194
42033,1010,1678,1481,40,12,471,668,197
42035,288,935,639,69,32,351,647,296
42037,679,1262,998,46,21,319,582,263
42039,1301,1818,1885,28,0,584,517,0
42041,2626,3945,3694,33,6,1068,1318,250
42043,4666,7632,7949,39,0,3283,2966,0
42045,12470,14646,15739,15,0,3269,2176,0
42047,453,745,655,39,12,202,293,91
42049,9094,11859,12126,23,0,3032,2765,0
42051,2271,7034,4048,68,42,1777,4763,2986
42053,25,50,30,50,40,5,25,20
42055,1172,2412,1633,51,32,461,1240,779
42057,223,339,260,34,23,37,116,79
42059,431,1094,800,61,27,369,663,294
42061,735,1116,1004,34,10,269,381,112
42063,1492,2715,1879,45,31,387,1223,836
42065,525,873,824,40,6,299,348,49
42067,92,298,118,69,60,26,206,180
42069,3916,7001,6914,44,1,2998,3085,87
42071,10245,13678,12544,25,8,2299,3433,1134
42073,1150,1661,2099,31,0,949,511,0
42075,2413,3523,3337,32,5,924,1110,186
42077,9021,12518,12162,28,3,3141,3497,356
42079,3697,8593,7721,57,10,4024,4897,873
42081,2486,3680,3291,32,11,805,1194,389
42083,807,1329,1261,39,5,454,522,68
42085,2052,3019,3235,32,0,1183,967,0
42087,321,1042,555,69,47,234,721,487
42089,2271,3181,2755,29,13,484,910,426
42091,9187,11636,12628,21,0,3441,2449,0
42093,281,441,412,36,7,131,160,29
42095,4254,6408,7148,34,0,2894,2154,0
42097,1991,3125,2897,36,7,906,1134,228
42099,474,699,593,32,15,119,226,107
42101,62563,103784,71542,40,31,8979,41221,32242
42103,502,1010,712,50,29,210,508,298
42105,330,543,411,39,24,81,213,132
42107,2324,3853,3480,40,10,1156,1529,373
42109,196,636,355,69,44,159,440,281
42111,764,1455,1162,48,20,398,691,293
42113,50,90,113,44,0,63,40,0
42115,408,820,550,50,33,142,412,270
42117,724,1302,1060,44,19,336,578,242
42119,231,751,577,69,23,346,520,174
42121,520,1035,952,50,8,432,514,82
42123,553,773,711,28,8,158,220,62
42125,1730,5598,3428,69,39,1698,3868,2170
42127,491,988,636,50,36,145,496,351
42129,3908,9143,7292,57,20,3384,5235,1851
42131,317,489,456,35,7,139,172,33
42133,6538,9583,8382,32,13,1844,3045,1201
44001,308,1068,625,71,41,317,760,443
44003,2921,5219,5269,44,0,2348,2298,0
44005,608,2110,1770,71,16,1162,1502,340
44007,17159,35110,34412,51,2,17253,17951,698
44009,3956,4934,5027,20,0,1071,978,0
45001,228,702,472,67,33,244,474,230
45003,1850,4013,2786,54,31,936,2163,1227
45005,244,442,341,45,23,97,198,101
45007,2605,4783,4081,46,15,1476,2178,702
45009,347,630,453,45,28,106,282,176
45011,505,916,736,45,20,231,411,180
45013,2660,3644,3249,27,11,589,984,395
45015,1062,2144,1488,50,31,426,1082,656
45017,210,380,288,45,24,78,170,92
45019,9557,13473,13036,29,3,3479,3916,437
45021,1113,2162,1627,49,25,514,1049,535
45023,758,1472,941,49,36,183,714,531
45025,231,906,553,75,39,322,675,353
45027,268,1308,510,80,61,242,1040,798
45029,401,791,613,49,23,212,391,179
45031,516,1124,968,54,14,452,608,156
45033,357,778,561,54,28,204,421,217
45035,1399,2764,2002,49,28,603,1364,761
45037,166,510,428,67,16,262,344,82
45039,314,556,503,44,10,189,243,54
45041,1893,4165,3213,55,23,1320,2273,953
45043,528,2579,865,80,66,337,2051,1714
45045,9485,15156,12561,37,17,3076,5671,2595
45047,695,2136,1488,67,30,793,1441,648
45049,346,628,500,45,20,154,281,127
45051,4532,6628,5479,32,17,947,2096,1149
45053,278,381,372,27,2,94,103,9
45055,290,1141,447,75,61,157,850,693
45057,458,1800,695,75,61,237,1342,1105
45059,1378,2443,1718,44,30,340,1065,725
45061,105,414,239,75,42,134,309,175
45063,2577,4733,3494,46,26,917,2155,1238
45065,78,239,146,67,39,68,161,93
45067,529,1165,943,55,19,414,635,221
45069,285,620,480,54,23,195,335,140
45071,728,1291,1148,44,11,420,563,143
45073,846,1480,1266,43,14,420,633,213
45075,2676,4851,3359,45,31,683,2174,1491
45077,2260,3951,2679,43,32,419,1692,1273
45079,8133,11735,12070,31,0,3937,3603,0
45081,75,229,160,67,30,85,155,70
45083,3702,8044,6001,54,25,2299,4342,2043
45085,2288,3087,3098,26,0,810,799,0
45087,524,1019,912,49,10,388,494,106
45089,266,1298,432,80,67,166,1032,866
45091,4577,6275,5765,27,8,1188,1698,510
46003,28,69,32,60,54,4,42,38
46005,299,560,530,47,5,231,262,31
46007,76,186,88,59,53,12,111,99
46009,34,86,67,60,22,33,52,19
46011,444,1336,651,67,51,207,892,685
46013,808,1516,1166,47,23,358,708,350
46015,106,266,133,60,50,27,160,133
46017,43,107,43,60,60,,64,64
46019,157,387,231,59,40,74,230,156
46021,9,17,10,47,41,1,8,7
46023,152,381,170,60,55,18,229,211
46025,11,32,18,67,45,7,21,14
46027,580,1384,657,58,53,77,804,727
46029,265,797,460,67,42,195,532,337
46031,63,154,78,59,50,15,92,77
46033,88,217,112,59,48,24,129,105
46035,511,1280,740,60,42,229,769,540
46037,73,138,100,47,27,27,64,37
46039,11,33,33,67,0,22,22,0
46041,108,266,113,59,57,5,158,153
46043,20,51,29,60,42,9,31,22
46045,49,92,55,47,40,6,43,37
46047,138,340,206,59,39,68,201,133
46049,39,74,49,47,33,10,34,24
46051,58,175,119,67,32,61,117,56
46053,44,109,67,60,39,23,66,43
46055,2,5,7,59,0,5,3,0
46057,16,47,30,67,37,14,32,18
46059,62,116,73,47,37,11,54,43
46061,6,16,7,60,54,1,9,8
46063,5,13,7,59,44,2,8,6
46065,328,822,488,60,41,160,494,334
46067,88,221,98,60,56,10,133,123
46069,14,34,23,60,34,9,20,11
46071,54,134,59,59,56,5,79,74
46073,38,72,43,47,40,5,34,29
46075,5,13,10,59,22,5,8,3
46077,17,51,32,67,37,15,34,19
46079,94,283,192,67,32,98,189,91
46081,634,1246,776,49,38,142,612,470
46083,278,512,381,46,26,103,234,131
46085,34,85,42,60,51,8,51,43
46087,21,63,29,67,54,8,42,34
46089,31,58,37,47,36,6,27,21
46091,66,124,74,47,40,8,58,50
46093,368,904,469,59,48,101,537,436
46095,25,61,30,59,51,5,36,31
46097,7,21,15,67,29,8,14,6
46099,4191,5203,5809,19,0,1618,1011,0
46101,15,45,25,67,45,10,30,20
46103,2236,4396,3378,49,23,1142,2160,1018
46105,18,43,60,59,0,42,26,0
46107,33,81,33,59,59,,48,48
46109,154,289,185,47,36,31,135,104
46111,28,70,33,60,53,5,42,37
46113,147,361,147,59,59,,214,214
46115,79,149,113,47,24,34,69,35
46117,64,161,82,60,49,18,97,79
46119,21,52,21,60,60,,31,31
46121,145,357,146,59,59,1,212,211
46123,106,265,124,60,53,18,159,141
46125,68,162,87,58,46,19,94,75
46127,141,337,173,58,49,32,196,164
46129,103,193,171,47,11,68,90,22
46135,400,955,643,58,33,243,555,312
46137,44,109,44,59,59,,65,65
47001,547,2148,1403,75,35,856,1601,745
47003,829,1314,1123,37,15,294,485,191
47005,266,400,310,33,22,44,134,90
47007,48,322,86,85,73,38,275,237
47009,1622,2608,2310,38,11,688,986,298
47011,2187,3283,2818,33,14,631,1097,466
47013,209,1144,591,82,48,382,936,554
47015,96,232,181,59,22,85,136,51
47017,533,801,693,33,13,160,268,108
47019,335,1566,948,79,39,613,1231,618
47021,425,871,437,51,50,12,446,434
47023,211,420,366,50,13,155,210,55
47025,135,743,233,82,69,98,607,509
47027,70,170,83,59,51,13,100,87
47029,339,746,605,55,19,266,407,141
47031,919,1614,1397,43,13,478,694,216
47033,163,287,194,43,32,31,124,93
47035,683,969,987,29,0,304,286,0
47037,15139,27189,23535,44,13,8396,12050,3654
47039,173,447,222,61,50,49,274,225
47041,167,405,323,59,20,156,238,82
47043,692,1419,1304,51,8,612,726,114
47045,863,1520,1276,43,16,413,657,244
47047,295,771,520,62,33,225,476,251
47049,208,504,258,59,49,50,296,246
47051,519,911,731,43,20,212,392,180
47053,948,1669,1301,43,22,353,721,368
47055,589,1118,815,47,27,226,529,303
47057,127,279,158,55,43,31,152,121
47059,362,1694,702,79,59,340,1331,991
47061,48,322,55,85,83,7,275,268
47063,709,1560,1331,55,15,622,852,230
47065,6115,12182,9041,50,26,2926,6067,3141
47067,36,195,86,82,56,50,160,110
47069,280,723,412,61,43,132,443,311
47071,291,751,350,61,53,59,461,402
47073,932,1871,1298,50,31,366,939,573
47075,413,1068,655,61,39,242,655,413
47077,327,846,479,61,43,152,519,367
47079,637,958,883,33,8,246,321,75
47081,334,633,387,47,39,53,299,246
47083,204,307,241,33,21,37,103,66
47085,266,400,385,33,4,119,134,15
47087,187,453,220,59,51,33,266,233
47089,766,1144,962,33,16,196,377,181
47091,89,416,233,79,44,144,327,183
47093,9394,17115,14700,45,14,5306,7720,2414
47095,151,265,309,43,0,158,115,0
47097,543,1421,824,62,42,281,878,597
47099,564,1070,786,47,27,222,506,284
47101,187,355,279,47,21,92,168,76
47103,415,728,677,43,7,262,313,51
47105,515,1171,824,56,30,309,656,347
47107,847,1272,1399,33,0,552,425,0
47109,188,487,282,61,42,94,298,204
47111,367,888,445,59,50,78,521,443
47113,2581,5152,3807,50,26,1226,2570,1344
47115,126,853,440,85,48,314,727,413
47117,469,744,739,37,1,270,275,5
47119,1491,2364,1967,37,17,476,873,397
47121,38,258,106,85,59,68,220,152
47123,592,1344,758,56,44,166,753,587
47125,2928,3889,3727,25,4,799,961,162
47127,31,54,36,43,34,5,23,18
47129,44,241,124,82,49,80,197,117
47131,478,842,755,43,10,277,364,87
47133,253,612,325,59,47,72,359,287
47135,104,197,115,47,42,11,93,82
47137,44,107,54,59,49,10,63,53
47139,187,281,217,33,23,30,94,64
47141,1837,2605,2265,29,13,428,768,340
47143,177,1194,458,85,62,281,1018,737
47145,836,1900,1321,56,30,485,1064,579
47147,718,1471,1069,51,27,351,753,402
47149,7091,8702,8175,19,6,1084,1611,527
47151,109,596,238,82,60,129,487,358
47153,30,206,124,85,40,94,175,81
47155,1286,1919,1564,33,19,278,634,356
47157,26157,34899,35257,25,0,9100,8742,0
47159,212,513,262,59,49,50,301,251
47161,253,381,269,33,29,16,128,112
47163,3211,4924,4571,35,7,1360,1713,353
47165,2210,2934,2974,25,0,764,723,0
47167,907,2372,1477,62,38,570,1465,895
47169,64,155,87,59,44,23,91,68
47171,74,347,182,79,47,108,273,165
47173,114,448,229,75,49,115,334,219
47175,58,140,81,59,42,23,82,59
47177,485,1174,924,59,21,439,689,250
47179,1953,3969,2869,51,28,916,2016,1100
47181,168,318,191,47,40,23,151,128
47183,774,1363,999,43,27,225,589,364
47185,303,430,451,29,0,148,127,0
47187,1019,1321,1284,23,3,265,302,37
47189,909,1318,1284,31,3,375,410,35
48001,564,957,768,41,20,204,394,190
48003,111,213,115,48,46,4,102,98
48005,1426,2059,2048,31,1,622,632,10
48007,331,692,398,52,42,67,361,294
48009,65,128,91,49,29,26,62,36
48011,15,25,17,40,32,2,10,8
48013,520,941,677,45,28,157,420,263
48015,168,342,248,51,27,80,174,94
48017,25,49,29,49,40,4,24,20
48019,144,263,145,45,45,1,119,118
48021,1289,1660,1568,22,6,279,371,92
48023,56,110,118,49,0,62,54,0
48025,278,580,496,52,15,218,302,84
48027,3444,5572,5152,38,8,1708,2129,421
48029,33558,47089,45650,29,3,12092,13531,1439
48031,65,124,87,48,30,22,60,38
48033,0,0,0,0,0,,0,0
48035,102,324,162,68,50,60,222,162
48037,1773,2499,2756,29,0,983,726,0
48039,4456,6258,5040,29,19,584,1802,1218
48041,11986,13782,13095,13,5,1109,1796,687
48043,165,317,191,48,40,26,151,125
48045,17,28,26,40,8,9,11,2
48047,168,357,361,53,0,193,189,0
48049,468,899,833,48,7,365,432,67
48051,113,230,167,51,27,54,117,63
48053,390,751,617,48,18,227,360,133
48055,918,1183,1223,22,0,305,265,0
48057,252,331,294,24,11,42,79,37
48059,52,165,124,68,25,72,113,41
48061,8053,14445,11122,44,23,3069,6392,3323
48063,124,328,188,62,43,64,203,139
48065,54,90,62,40,31,8,36,28
48067,365,514,579,29,0,214,149,0
48069,85,143,110,40,23,25,57,32
48071,76,280,85,73,70,9,205,196
48073,539,745,758,28,0,219,205,0
48075,101,168,181,40,0,80,68,0
48077,46,89,60,49,33,14,44,30
48079,18,35,22,49,37,4,17,13
48081,44,62,59,28,4,15,17,2
48083,100,192,229,48,0,129,92,0
48085,7276,8255,8222,12,0,946,979,33
48087,32,54,51,40,5,19,22,3
48089,310,394,360,21,9,50,85,35
48091,476,1031,790,54,23,314,555,241
48093,79,252,147,68,41,68,173,105
48095,2,31,15,93,51,13,29,16
48097,529,869,760,39,13,231,340,109
48099,640,1458,837,56,43,197,817,620
48101,17,34,41,49,0,24,16,0
48103,42,80,42,48,48,,38,38
48105,8,113,10,93,91,2,105,103
48107,67,130,89,49,32,22,63,41
48109,21,40,30,48,25,9,19,10
48111,54,90,75,40,17,21,36,15
48113,71280,85381,87346,17,0,16066,14101,0
48115,13,190,77,93,59,64,177,113
48117,203,340,398,40,0,195,136,0
48119,47,90,102,47,0,55,42,0
48121,10984,12611,11788,13,7,804,1627,823
48123,144,261,326,45,0,182,117,0
48125,12,23,26,49,0,14,11,0
48127,166,270,348,39,0,182,104,0
48129,57,94,83,40,13,26,38,12
48131,98,205,193,52,6,95,107,12
48133,102,322,234,68,28,132,221,89
48135,1554,2527,2155,39,15,601,973,372
48137,21,34,21,39,39,,13,13
48139,2438,2998,2796,19,7,358,560,202
48141,16685,25678,23787,35,7,7102,8993,1891
48143,468,1486,557,68,62,89,1017,928
48145,145,263,271,45,0,126,118,0
48147,713,892,925,20,0,212,178,0
48149,329,423,442,22,0,113,95,0
48151,65,91,100,29,0,35,26,0
48153,145,282,178,49,37,33,137,104
48155,18,35,25,49,29,7,17,10
48157,1611,2902,2255,44,22,644,1291,647
48159,77,147,114,47,22,37,70,33
48161,166,300,228,45,24,62,134,72
48163,90,164,283,45,0,193,74,0
48165,74,143,94,48,34,20,68,48
48167,6274,8222,7883,24,4,1609,1948,339
48169,26,50,57,49,0,31,24,0
48171,192,351,207,45,41,15,159,144
48173,0,0,0,0,0,,0,0
48175,79,142,114,45,20,35,64,29
48177,194,350,323,45,8,129,157,28
48179,269,449,381,40,15,112,180,68
48181,1576,2588,2447,39,5,871,1012,141
48183,2485,3324,3331,25,0,846,839,0
48185,220,447,309,51,31,89,227,138
48187,539,1169,1079,54,8,540,630,90
48189,393,765,646,49,16,253,372,119
48191,50,84,90,40,0,40,34,0
48193,41,78,84,48,0,43,38,0
48195,50,83,62,40,26,12,33,21
48197,35,69,79,49,0,44,34,0
48199,448,706,523,37,26,75,258,183
48201,112581,137499,128489,18,7,15908,24918,9010
48203,897,1200,1277,25,0,380,303,0
48205,37,61,41,40,34,4,25,21
48207,121,170,164,29,4,43,49,6
48209,4915,5734,5351,14,7,436,819,383
48211,29,49,30,40,38,1,20,19
48213,829,1409,1057,41,25,228,579,351
48215,15191,23744,20905,36,12,5714,8553,2839
48217,258,468,359,45,23,101,209,108
48219,194,378,278,49,26,84,184,100
48221,261,829,331,68,60,70,568,498
48223,507,964,584,47,39,77,457,380
48225,646,863,868,25,0,222,216,0
48227,94,1344,316,93,76,222,1250,1028
48229,14,27,14,48,48,,13,13
48231,2403,3003,2981,20,1,578,601,23
48233,173,289,245,40,15,72,116,44
48235,0,5,0,93,93,,5,5
48237,44,85,50,49,42,6,42,36
48239,139,183,202,24,0,63,43,0
48241,453,1079,648,58,40,195,626,431
48243,12,23,12,48,48,,11,11
48245,4576,7589,7584,40,0,3008,3013,5
48247,57,120,116,53,4,59,64,5
48249,469,980,832,52,15,363,511,148
48251,1385,2036,1719,32,16,334,651,317
48253,167,234,290,29,0,123,67,0
48255,187,338,318,45,6,131,151,20
48257,1281,1899,1653,33,13,372,618,246
48259,369,673,417,45,38,48,304,256
48261,0,0,0,0,0,,0,0
48263,6,8,6,29,29,,2,2
48265,542,990,620,45,37,78,448,370
48267,7,102,26,93,74,19,95,76
48269,2,4,2,49,49,,2,2
48271,42,69,65,39,5,23,27,4
48273,857,1820,1235,53,32,378,962,584
48275,59,116,98,49,15,39,57,18
48277,787,1496,1170,47,22,383,709,326
48279,72,141,122,49,13,50,69,19
48281,202,388,267,48,31,65,186,121
48283,68,111,108,39,3,40,43,3
48285,218,277,286,21,0,68,60,0
48287,221,285,227,22,20,6,64,58
48289,108,219,140,51,36,32,111,79
48291,295,1090,643,73,41,348,795,447
48293,132,239,187,45,22,55,107,52
48295,10,17,17,40,0,7,7,0
48297,67,140,103,52,26,36,73,37
48299,190,365,236,48,35,46,175,129
48301,0,0,0,0,0,,0,0
48303,8681,11020,9720,21,12,1039,2339,1300
48305,43,84,91,49,0,48,41,0
48307,12,169,139,93,18,127,157,30
48309,7874,10947,9751,28,11,1877,3073,1196
48311,4,9,4,52,52,,4,4
48313,93,189,133,51,30,40,96,56
48315,76,200,121,62,40,45,124,79
48317,3,42,3,93,93,,39,39
48319,6,83,14,93,83,8,78,70
48321,1012,1289,1382,21,0,370,277,0
48323,689,1123,1076,39,4,387,434,47
48325,338,617,426,45,31,88,279,191
48327,4,55,4,93,93,,51,51
48329,2641,3238,3057,18,6,416,597,181
48331,654,843,846,22,0,192,189,0
48333,16,30,34,48,0,18,15,0
48335,152,214,215,29,0,63,62,0
48337,203,398,222,49,44,19,195,176
48339,3155,6463,4328,51,33,1173,3308,2135
48341,226,377,258,40,32,32,151,119
48343,149,284,231,47,18,82,134,52
48345,13,25,16,49,36,3,12,9
48347,1707,2463,2304,31,6,597,757,160
48349,519,939,809,45,14,290,421,131
48351,84,200,114,58,43,30,116,86
48353,418,587,587,29,0,169,169,0
48355,8917,12417,11790,28,5,2873,3501,628
48357,100,167,122,40,27,22,67,45
48359,17,28,19,40,33,2,11,9
48361,1162,1832,1601,37,13,439,670,231
48363,908,1276,1026,29,20,118,368,250
48365,162,224,245,28,0,83,62,0
48367,1269,1609,1650,21,0,381,340,0
48369,107,179,128,40,28,21,72,51
48371,129,248,206,48,17,77,119,42
48373,1216,1623,1393,25,14,177,407,230
48375,3448,4368,4191,21,4,743,920,177
48377,33,64,72,48,0,39,31,0
48379,41,107,57,62,47,16,66,50
48381,2273,3009,2643,24,12,370,736,366
48383,3,40,6,93,86,3,38,35
48385,29,48,29,39,39,,19,19
48387,158,301,270,47,10,112,143,31
48389,76,146,143,48,2,67,70,3
48391,54,113,87,52,23,33,59,26
48393,1,2,1,40,40,,1,1
48395,245,497,480,51,4,235,253,18
48397,530,786,626,33,20,96,256,160
48399,13,179,58,93,68,45,166,121
48401,320,442,436,28,1,116,122,6
48403,69,165,100,58,39,31,96,65
48405,136,324,193,58,40,57,188,131
48407,316,422,323,25,23,7,106,99
48409,980,1569,1608,38,0,628,588,0
48411,39,74,71,48,5,32,36,4
48413,6,86,21,93,76,15,80,65
48415,372,522,421,29,19,49,150,101
48417,39,54,39,29,29,,16,16
48419,417,994,551,58,45,134,577,443
48421,35,59,38,40,35,3,24,21
48423,4024,5054,4758,20,6,734,1030,296
48425,43,136,57,68,58,14,93,79
48427,620,1316,805,53,39,185,696,511
48429,225,317,323,29,0,98,91,0
48431,2,23,2,93,93,,21,21
48433,28,40,43,29,0,15,11,0
48435,1,12,5,93,60,4,11,7
48437,101,168,182,40,0,81,68,0
48439,37535,46012,44651,18,3,7116,8477,1361
48441,1825,2071,2317,12,0,492,246,0
48443,9,17,9,48,48,,8,8
48445,174,340,264,49,22,90,165,75
48447,27,38,37,29,2,10,11,1
48449,341,648,472,47,27,131,307,176
48451,2447,3405,3150,28,8,703,959,256
48453,37059,43086,42553,14,1,5494,6027,533
48455,369,492,390,25,21,21,123,102
48457,312,743,347,58,53,35,431,396
48459,219,577,383,62,34,164,358,194
48461,2,35,2,93,93,,32,32
48463,420,684,582,39,15,162,264,102
48465,886,1443,1387,39,4,501,558,57
48467,382,1007,554,62,45,172,625,453
48469,1677,2200,2262,24,0,585,524,0
48471,3501,4671,3787,25,19,286,1170,884
48473,677,1204,747,44,38,70,527,457
48475,84,162,158,48,2,74,77,3
48477,513,1044,757,51,27,244,531,287
48479,4190,6397,5288,35,17,1098,2207,1109
48481,1102,1403,1275,21,9,173,302,129
48483,56,94,77,40,18,21,38,17
48485,2454,5232,3410,53,35,956,2778,1822
48487,284,555,385,49,31,101,272,171
48489,215,456,314,53,31,99,241,142
48491,2883,3877,3611,26,7,728,994,266
48493,211,381,289,45,24,78,170,92
48495,52,99,83,48,16,31,47,16
48497,359,704,389,49,45,30,344,314
48499,218,576,269,62,53,51,357,306
48501,17,33,24,49,27,7,16,9
48503,329,645,446,49,31,117,316,199
48505,343,728,423,53,42,80,385,305
48507,255,415,533,39,0,278,160,0
49001,44,63,66,30,0,22,19,0
49003,295,361,398,18,0,103,66,0
49005,1719,2104,1946,18,8,227,385,158
49007,363,565,523,36,7,160,202,42
49009,11,16,11,36,36,,6,6
49011,2437,2943,3221,17,0,784,506,0
49013,173,270,204,36,24,31,96,65
49015,86,134,120,36,10,34,48,14
49017,13,19,13,30,30,,6,6
49019,138,214,166,36,23,28,77,49
49021,545,781,600,30,23,55,235,180
49023,58,83,58,30,30,,25,25
49025,49,71,49,30,30,,21,21
49027,78,111,78,30,30,,33,33
49029,7,11,7,36,36,,4,4
49031,2,3,2,30,30,,1,1
49033,5,6,5,18,18,,1,1
49035,14379,20330,18479,29,9,4100,5951,1851
49037,128,199,128,36,36,,71,71
49039,117,167,120,30,28,3,50,47
49041,98,140,121,30,14,23,42,19
49043,467,727,468,36,36,1,260,259
49045,498,610,648,18,0,150,112,0
49047,271,423,306,36,27,35,151,116
49049,6921,8080,8036,14,1,1115,1159,44
49051,229,356,230,36,35,1,127,126
49053,1572,2250,1726,30,23,154,678,524
49055,7,11,7,30,30,,3,3
49057,2663,3588,3974,26,0,1311,925,0
50001,518,696,624,26,10,106,179,73
50003,640,861,910,26,0,270,221,0
50005,440,1111,579,60,48,139,672,533
50007,4571,5858,6376,22,0,1805,1287,0
50009,62,158,95,60,39,33,95,62
50011,889,1139,1275,22,0,386,250,0
50013,87,111,128,22,0,41,24,0
50015,375,947,473,60,50,98,572,474
50017,296,508,439,42,14,143,212,69
50019,337,853,411,60,52,74,515,441
50021,1099,1478,1590,26,0,491,379,0
50023,829,2095,1379,60,34,550,1266,716
50025,788,1353,1201,42,11,413,565,152
50027,1005,1725,1461,42,15,456,720,264
51001,418,681,507,39,26,89,263,174
51003,1935,2427,2165,20,11,230,492,262
51005,58,103,192,44,0,134,45,0
51007,65,152,65,58,58,,88,88
51009,279,599,303,53,49,24,320,296
51011,88,207,118,58,43,30,119,89
51013,5559,6651,7271,16,0,1712,1092,0
51015,753,1339,867,44,35,114,586,472
51017,15,26,16,44,40,1,11,10
51019,434,932,438,53,53,4,497,493
51021,88,171,88,49,49,,83,83
51023,96,148,97,35,34,1,52,51
51025,258,494,295,48,40,37,236,199
51027,368,715,436,49,39,68,347,279
51029,83,195,84,58,57,1,112,111
51031,701,1504,796,53,47,95,803,708
51033,248,405,284,39,30,36,156,120
51035,437,849,551,49,35,114,412,298
51036,17,35,19,52,46,2,18,16
51037,102,241,104,58,57,2,139,137
51041,2826,3201,3310,12,0,484,375,0
51043,96,213,113,55,47,17,118,101
51045,28,50,44,44,12,16,22,6
51047,873,1099,1047,21,5,174,227,53
51049,89,209,159,58,24,70,120,50
51051,210,476,408,56,14,198,267,69
51053,218,452,267,52,41,49,234,185
51057,117,191,152,39,20,35,74,39
51059,10765,15056,14902,28,1,4137,4291,154
51061,324,723,503,55,30,179,399,220
51063,219,283,235,23,17,16,64,48
51065,180,226,209,20,7,29,46,17
51067,313,701,433,55,38,120,388,268
51069,916,1347,970,32,28,54,431,377
51071,306,396,398,23,0,92,90,0
51073,238,275,330,14,0,92,38,0
51075,24,36,35,32,1,11,11,0
51077,212,412,272,49,34,60,200,140
51079,225,282,291,20,0,66,57,0
51081,116,222,131,48,41,15,106,91
51083,341,804,444,58,45,103,462,359
51085,371,544,568,32,0,197,173,0
51087,4115,6256,6081,34,3,1966,2141,175
51089,519,1164,629,55,46,110,645,535
51091,25,45,25,44,44,,20,20
51093,266,447,510,40,0,244,180,0
51095,555,643,631,14,2,76,88,12
51097,65,106,74,39,30,9,41,32
51099,204,339,205,40,40,1,136,135
51101,106,173,135,39,22,29,67,38
51103,151,247,191,39,22,40,95,55
51105,323,734,707,56,4,384,411,27
51107,1339,2989,1851,55,38,512,1650,1138
51109,404,668,483,40,28,79,265,186
51111,184,353,187,48,47,3,169,166
51113,95,157,105,40,33,10,62,52
51115,47,55,59,14,0,12,7,0
51117,405,776,468,48,40,63,371,308
51119,91,148,110,39,26,19,57,38
51121,4808,6216,5209,23,16,401,1408,1007
51125,177,315,207,44,34,30,138,108
51127,86,178,88,52,51,2,92,90
51131,253,413,425,39,0,172,160,0
51133,81,131,94,39,29,13,51,38
51135,173,408,173,58,58,,235,235
51137,336,556,408,40,27,72,220,148
51139,313,519,324,40,37,11,205,194
51141,91,205,120,55,41,29,114,85
51143,633,1235,725,49,41,92,602,510
51145,56,82,75,32,9,19,26,7
51147,265,624,345,58,45,80,359,279
51149,248,514,304,52,41,56,266,210
51153,4337,5159,5366,16,0,1029,822,0
51155,914,1182,1130,23,4,216,268,52
51157,104,172,108,40,37,4,68,64
51159,52,84,59,39,30,7,32,25
51161,615,945,999,35,0,384,330,0
51163,419,746,461,44,38,42,326,284
51165,853,1413,936,40,34,83,559,476
51167,347,789,534,56,32,187,442,255
51169,366,761,531,52,30,165,395,230
51171,675,993,832,32,16,157,318,161
51173,493,1026,857,52,16,364,532,168
51175,270,517,279,48,46,9,247,238
51177,1588,2000,1860,21,7,272,412,140
51179,852,1422,1107,40,22,255,569,314
51181,59,112,66,48,42,7,54,47
51183,210,402,310,48,23,100,192,92
51185,916,1780,1164,49,35,248,865,617
51187,256,572,374,55,35,118,316,198
51191,1103,2293,1255,52,45,152,1190,1038
51193,142,232,218,39,6,76,90,14
51195,613,1395,1080,56,23,467,781,314
51197,497,967,773,49,20,276,469,193
51199,381,441,503,14,0,122,60,0
51510,2733,3822,4874,28,0,2141,1089,0
51515,158,340,294,53,13,136,182,46
51520,591,1229,1017,52,17,426,638,212
51530,174,309,208,44,33,34,135,101
51540,1935,2427,2675,20,0,740,492,0
51550,2394,2885,3688,17,0,1294,491,0
51570,254,526,355,52,33,101,272,171
51580,111,197,181,44,8,70,86,16
51590,1463,2853,2401,49,16,938,1390,452
51595,174,334,287,48,14,113,160,47
51600,273,324,312,16,4,39,51,12
51610,142,204,240,30,0,98,62,0
51620,395,757,616,48,19,221,362,141
51630,1244,1566,1822,21,0,578,323,0
51640,332,646,473,49,27,141,314,173
51650,3410,4834,5151,29,0,1741,1424,0
51660,1730,2864,2095,40,27,365,1134,769
51670,579,1199,1136,52,5,557,620,63
51678,169,301,225,44,25,56,132,76
51680,1517,3256,2857,53,12,1340,1739,399
51683,430,673,545,36,19,115,243,128
51685,96,151,131,36,13,35,55,20
51690,270,605,421,55,30,151,335,184
51700,3919,7230,7916,46,0,3997,3311,0
51710,7756,12036,11961,36,1,4205,4280,75
51720,93,212,272,56,0,179,119,0
51730,867,1796,1862,52,0,995,929,0
51735,56,64,67,14,0,11,9,0
51740,2215,3713,4025,40,0,1810,1499,0
51750,1127,1457,1296,23,11,169,330,161
51760,8831,15144,14580,42,4,5749,6313,564
51770,3195,5178,4994,38,4,1799,1983,184
51775,453,734,480,38,35,27,281,254
51790,678,1205,971,44,19,293,527,234
51800,1056,1770,1903,40,0,847,714,0
51810,3547,4986,4977,29,0,1430,1439,9
51820,647,1150,950,44,17,303,503,200
51830,211,244,275,14,0,64,33,0
51840,746,1098,832,32,24,86,351,265
53001,292,506,353,42,30,61,213,152
53003,559,788,744,29,6,185,229,44
53005,3117,4779,3901,35,18,784,1662,878
53007,1168,1598,1473,27,8,305,430,125
53009,1941,2583,2278,25,12,337,643,306
53011,6356,8780,8052,28,8,1696,2424,728
53013,123,173,141,29,19,18,50,32
53015,2163,3199,2902,32,9,739,1036,297
53017,613,839,676,27,19,63,226,163
53019,81,139,106,42,24,25,59,34
53021,1283,1968,1692,35,14,409,685,276
53023,45,64,45,29,29,,19,19
53025,1451,2511,1821,42,27,370,1059,689
53027,1718,2572,2160,33,16,442,854,412
53029,932,1566,1219,41,22,287,635,348
53031,750,999,855,25,14,105,248,143
53033,51656,72696,58655,29,19,6999,21040,14041
53035,2902,5411,4502,46,17,1600,2509,909
53037,1534,2099,1775,27,15,241,565,324
53039,388,574,494,32,14,106,186,80
53041,1513,2265,1751,33,23,238,752,514
53043,151,261,163,42,38,12,110,98
53045,701,933,803,25,14,102,232,130
53047,739,1011,939,27,7,200,272,72
53049,536,803,584,33,27,48,266,218
53051,196,340,246,42,27,50,143,93
53053,17255,22623,22326,24,1,5071,5368,297
53055,240,404,251,41,38,11,164,153
53057,1809,3041,2162,41,29,353,1232,879
53059,112,166,191,32,0,79,54,0
53061,12603,17667,17087,29,3,4484,5064,580
53063,10644,14043,14023,24,0,3379,3399,20
53065,462,799,573,42,28,111,337,226
53067,5801,7448,7046,22,5,1245,1647,402
53069,72,106,87,32,18,15,34,19
53071,1768,2494,2267,29,9,499,726,227
53073,4688,6991,6066,33,13,1378,2303,925
53075,2364,3335,2528,29,24,164,970,806
53077,5374,7312,6249,27,15,875,1938,1063
54001,319,659,432,52,35,113,341,228
54003,1223,2657,1831,54,31,608,1433,825
54005,315,676,412,53,39,97,360,263
54007,173,358,214,52,40,41,185,144
54009,386,593,539,35,9,153,207,54
54011,1653,3438,2983,52,13,1330,1785,455
54013,96,174,158,45,9,62,78,16
54015,108,230,143,53,38,35,123,88
54017,44,69,46,36,33,2,25,23
54019,675,1417,955,52,33,280,742,462
54021,186,385,207,52,46,21,199,178
54023,107,232,159,54,32,52,125,73
54025,775,1628,1034,52,36,259,853,594
54027,269,584,361,54,38,92,315,223
54029,931,1431,1120,35,22,189,500,311
54031,55,119,65,54,46,10,64,54
54033,1435,2247,1967,36,12,532,812,280
54035,360,653,681,45,0,321,293,0
54037,525,1140,688,54,40,163,615,452
54039,3383,7250,5909,53,18,2526,3867,1341
54041,365,755,509,52,33,144,390,246
54043,243,871,363,72,58,120,627,507
54045,383,1369,615,72,55,232,986,754
54047,173,770,323,77,58,150,597,447
54049,962,1506,1328,36,12,366,544,178
54051,831,1277,1116,35,13,285,446,161
54053,184,383,419,52,0,235,199,0
54055,654,2901,1027,77,65,373,2247,1874
54057,353,768,657,54,14,304,414,110
54059,226,808,575,72,29,349,582,233
54061,3831,5278,4101,27,22,270,1447,1177
54063,33,130,68,75,48,35,97,62
54065,191,416,219,54,47,28,224,196
54067,231,485,378,52,22,147,254,107
54069,1532,2355,2275,35,3,743,822,79
54071,96,208,102,54,51,6,112,106
54073,88,159,119,45,25,31,71,40
54075,99,208,107,52,49,8,109,101
54077,396,546,502,27,8,106,150,44
54079,474,1015,625,53,38,151,541,390
54081,465,1842,1164,75,37,699,1377,678
54083,516,1068,738,52,31,222,552,330
54085,134,242,164,45,32,30,109,79
54087,287,521,378,45,27,91,234,143
54089,56,223,188,75,15,132,166,34
54091,167,262,319,36,0,152,95,0
54093,120,248,147,52,41,27,128,101
54095,119,216,139,45,36,20,97,77
54097,314,649,519,52,20,205,335,130
54099,477,1707,806,72,53,329,1230,901
54101,161,337,253,52,25,92,177,85
54103,429,659,615,35,7,186,230,44
54105,119,216,144,45,33,25,97,72
54107,2371,4300,3207,45,25,836,1929,1093
54109,120,532,267,77,50,147,412,265
55001,229,381,243,40,36,14,152,138
55003,223,590,402,62,32,179,367,188
55005,575,1184,859,51,27,284,610,326
55007,142,375,196,62,48,54,233,179
55009,6695,9270,8718,28,6,2023,2575,552
55011,163,393,186,58,53,23,229,206
55013,165,437,215,62,51,50,272,222
55015,570,808,736,29,9,166,238,72
55017,761,1591,1123,52,29,362,830,468
55019,181,373,295,51,21,114,192,78
55021,311,1079,546,71,49,235,768,533
55023,219,526,329,58,37,110,307,197
55025,14317,18870,17601,24,7,3284,4553,1269
55027,489,1694,777,71,54,288,1205,917
55029,306,790,436,61,45,130,484,354
55031,608,1611,1230,62,24,622,1003,381
55033,510,1050,662,51,37,152,541,389
55035,2145,4487,2782,52,38,637,2342,1705
55037,28,72,58,61,20,30,44,14
55039,1850,2896,2552,36,12,702,1047,345
55041,105,174,144,40,17,39,69,30
55043,784,1227,989,36,19,205,443,238
55045,392,613,489,36,20,97,221,124
55047,246,386,351,36,9,105,139,34
55049,261,408,351,36,14,90,147,57
55051,79,210,120,62,43,41,131,90
55053,233,559,300,58,46,67,326,259
55055,1515,2507,1906,40,24,391,992,601
55057,308,511,389,40,24,81,204,123
55059,3237,4745,4686,32,1,1449,1508,59
55061,107,276,154,61,44,47,169,122
55063,1837,4116,2673,55,35,836,2279,1443
55065,168,262,206,36,22,38,95,57
55067,279,464,441,40,5,162,185,23
55069,376,625,511,40,18,135,249,114
55071,652,1681,1074,61,36,422,1029,607
55073,1092,1712,1624,36,5,532,620,88
55075,396,1021,693,61,32,297,625,328
55077,186,292,205,36,30,19,106,87
55078,30,46,44,36,6,14,17,3
55079,42250,57248,55331,26,3,13081,14998,1917
55081,609,1464,824,58,44,215,855,640
55083,182,471,316,61,33,134,288,154
55085,547,910,696,40,23,149,362,213
55087,3549,5028,4309,29,14,760,1479,719
55089,1730,2068,1997,16,3,267,337,70
55091,60,144,67,58,54,7,84,77
55093,636,1528,794,58,48,158,892,734
55095,355,732,556,51,24,201,377,176
55097,1402,2331,1680,40,28,278,928,650
55099,152,402,219,62,46,67,250,183
55101,3984,6608,5133,40,22,1149,2624,1475
55103,294,460,435,36,5,141,166,25
55105,2979,4172,4416,29,0,1437,1193,0
55107,164,435,240,62,45,76,270,194
55109,669,1378,1016,51,26,347,709,362
55111,367,1270,641,71,50,274,904,630
55113,257,681,362,62,47,105,424,319
55115,579,906,691,36,24,112,327,215
55117,1682,3170,2254,47,29,572,1488,916
55119,150,397,233,62,41,83,247,164
55121,331,794,509,58,36,178,464,286
55123,295,709,453,58,36,158,414,256
55125,325,541,360,40,33,35,215,180
55127,2560,4237,2990,40,29,430,1677,1247
55129,208,549,293,62,47,85,342,257
55131,2362,2822,2903,16,0,541,461,0
55133,3573,5366,4846,33,10,1273,1793,520
55135,852,1334,1086,36,19,234,482,248
55137,264,413,303,36,27,39,149,110
55139,4263,6039,5498,29,9,1235,1776,541
55141,1102,1831,1715,40,6,613,729,116
56001,748,1583,939,53,41,191,836,645
56003,110,198,111,45,44,1,88,87
56005,290,523,362,45,31,72,233,161
56007,108,238,159,55,33,51,130,79
56009,222,400,347,45,13,125,178,53
56011,61,110,61,45,45,,49,49
56013,476,1049,591,55,44,115,573,458
56015,201,363,255,45,30,54,162,108
56017,120,216,156,45,28,36,96,60
56019,100,180,124,45,31,24,80,56
56021,720,1526,1405,53,8,685,805,120
56023,59,152,71,61,53,12,93,81
56025,1472,3245,1983,55,39,511,1773,1262
56027,29,52,49,45,6,20,23,3
56029,205,524,261,61,50,56,320,264
56031,107,193,131,45,32,24,86,62
56033,586,1057,778,45,26,192,471,279
56035,21,53,21,61,61,,32,32
56037,153,392,357,61,9,204,239,35
56039,180,462,180,61,61,,282,282
56041,89,228,164,61,28,75,139,64
56043,75,136,113,45,17,38,60,22
56045,39,71,52,45,26,13,32,19
